"TotalCases","StudentCases","EmployeeCases","nycsr_locationsiteid","nycsr_sitename","nycsr_building.nycsr_buildingid","nycsr_building.nycsr_longitude","nycsr_building.nycsr_latitude","nycsr_building.nycsr_buildingname","nycsr_building.nycsr_address"
2,0,2,"cc0d3c5b-30f4-ea11-b882-24ee9a37d45c","P.S. 97 The Highlawn - K097 - K097 - 21K097 - 1846 West 13 Street","cd0d3c5b-30f4-ea11-b882-24ee9a37d45c",-73985570,40601191,"P.S. 97 - BROOKLYN","1846 West 13 Street"
5,2,3,"6a5bc58c-30f4-ea11-b882-24ee9a37d45c","J.H.S. 220 John J. Pershing - K220 - K220 - 20K220 - 4812 9TH AVENUE","695bc58c-30f4-ea11-b882-24ee9a37d45c",-74001250,40640997,"I.S. 220 - BROOKLYN","4812 9TH AVENUE"
1,0,1,"039c4c1f-32f4-ea11-b882-24ee9a37d45c","P.S. 163 Flushing Heights - Q163 - Q163 - 25Q163 - 159-01 59 AVENUE","049c4c1f-32f4-ea11-b882-24ee9a37d45c",-73808765,40741107,"P.S. 163 - QUEENS","159-01 59 AVENUE"
3,2,1,"cc2ff20c-32f4-ea11-b882-24ee9a37d45c","The James J. Ambrose School - Q115 - Q115 - 26Q115 - 80-51 261 STREET","cd2ff20c-32f4-ea11-b882-24ee9a37d45c",-73709404,40744201,"The James J. Ambrose School","80-51 261 STREET"
1,1,0,"12cf496e-31f4-ea11-b882-24ee9a37d45c","Dos Puentes Elementary School - M103 - M132 - 06M103 - 185 WADSWORTH AVENUE","10cf496e-31f4-ea11-b882-24ee9a37d45c",-73933964,40850561,"P.S. 132 - MANHATTAN","185 WADSWORTH AVENUE"
5,3,2,"d60d3c5b-30f4-ea11-b882-24ee9a37d45c","P.S. 101 The Verrazano - K101 - K101 - 21K101 - 8696 24 Avenue","d70d3c5b-30f4-ea11-b882-24ee9a37d45c",-73991962,40597379,"P.S. 101 - BROOKLYN","8696 24 Avenue"
7,5,2,"29b7c337-32f4-ea11-b882-24ee9a37d45c","I.S. 227 Louis Armstrong - Q227 - Q227 - 30Q227 - 32-02 JUNCTION BOULEVARD","27b7c337-32f4-ea11-b882-24ee9a37d45c",-73874614,40757567,"I.S. 227 - QUEENS","32-02 JUNCTION BOULEVARD"
1,0,1,"54ebaa73-30f4-ea11-b882-24ee9a37d45c","P.S. 169 Sunset Park - K169 - K169 - 15K169 - 4305 7 AVENUE","55ebaa73-30f4-ea11-b882-24ee9a37d45c",-74001700,40645825,"P.S. 169 - BROOKLYN","4305 7 AVENUE"
3,3,0,"546e70b7-31f4-ea11-b882-24ee9a37d45c","Millennium High School - M418 - M824 - 02M418 - 75 BROAD STREET","760c1bb1-31f4-ea11-b882-24ee9a37d45c",-74011202,0,"MILLENNIUM HS - MANHATTAN","75 BROAD STREET"
1,0,1,"92977d2b-32f4-ea11-b882-24ee9a37d45c","P.S. 197 The Ocean School - Q197 - Q197 - 27Q197 - 825 HICKSVILLE ROAD","93977d2b-32f4-ea11-b882-24ee9a37d45c",-73744128,40599664,"P.S. 197 - QUEENS","825 HICKSVILLE ROAD"
4,4,0,"c837fba4-31f4-ea11-b882-24ee9a37d45c","Park East High School - M495 - M495 - 04M495 - 230 EAST 105 STREET","c737fba4-31f4-ea11-b882-24ee9a37d45c",-73944092,40790191,"PARK EAST HS - MANHATTAN","230 EAST 105 STREET"
1,0,1,"28a6ba98-31f4-ea11-b882-24ee9a37d45c","The College Academy - M462 - M465 - 06M462 - 549 AUDUBON AVENUE","25a6ba98-31f4-ea11-b882-24ee9a37d45c",-73926060,40856532,"G. WASHINGTON HS EDUC. CAMPUS - M","549 AUDUBON AVENUE"
8,6,2,"4c8dbfcf-30f4-ea11-b882-24ee9a37d45c","Midwood High School - K405 - K405 - 22K405 - 2839 BEDFORD AVENUE","4d8dbfcf-30f4-ea11-b882-24ee9a37d45c",-73952356,40632829,"MIDWOOD HS - K","2839 BEDFORD AVENUE"
2,2,0,"d2b66262-32f4-ea11-b882-24ee9a37d45c","Forest Hills High School - Q440 - Q440 - 28Q440 - 67-01 110 STREET","d3b66262-32f4-ea11-b882-24ee9a37d45c",-73843972,40730017,"FOREST HILLS HS - Q","67-01 110 STREET"
1,0,1,"f4fb3df4-30f4-ea11-b882-24ee9a37d45c","P.S. 160 William T. Sampson - K160 - K521 - 20K160 - 1057 52ND STREET","f5fb3df4-30f4-ea11-b882-24ee9a37d45c",-73999057,0,"P.S. 160 ANNEX - BROOKLYN","1057 52ND STREET"
4,0,4,"515bc58c-30f4-ea11-b882-24ee9a37d45c","P.S. 215 Morris H. Weiss - K215 - K215 - 21K215 - 415 AVENUE S","505bc58c-30f4-ea11-b882-24ee9a37d45c",-73970171,40602722,"P.S. 215 - BROOKLYN","415 AVENUE S"
1,1,0,"e42ece86-32f4-ea11-b882-24ee9a37d45c","Young Women's Leadership School, Astoria - Q286 - Q739 - 30Q286 - 23-15 Newtown Avenue","e52ece86-32f4-ea11-b882-24ee9a37d45c",-73923830,0,"YOUNG WOMEN'S LEADERSHIP ACADEMY- QUEENS","23-15 Newtown Avenue"
2,1,1,"2cff3d8d-33f4-ea11-b882-24ee9a37d45c","Health Opportunities High School - X670 - X884 - 07X670 - 350 Gerard Avenue","2dff3d8d-33f4-ea11-b882-24ee9a37d45c",-73929960,40815712,"HEALTH OPPORTUNITIES HS - X","350 Gerard Avenue"
1,1,0,"44ff3d8d-33f4-ea11-b882-24ee9a37d45c","High School of American Studies at Lehman College - X696 - X905 - 10X696 - 2925 Goulden Avenue","45ff3d8d-33f4-ea11-b882-24ee9a37d45c",-73895543,40874725,"HS OF AMERICAN STUDIES - BRONX","2925 Goulden Avenue"
1,0,1,"10ba8b86-30f4-ea11-b882-24ee9a37d45c","P.S. 205 Clarion - K205 - K205 - 20K205 - 6701 20 AVENUE","11ba8b86-30f4-ea11-b882-24ee9a37d45c",-73986792,40614737,"P.S. 205 - BROOKLYN","6701 20 AVENUE"
3,1,2,"f1b98b86-30f4-ea11-b882-24ee9a37d45c","P.S. 196 Ten Eyck - K196 - K196 - 14K196 - 207 BUSHWICK AVENUE","e9b98b86-30f4-ea11-b882-24ee9a37d45c",-73939385,40708804,"P.S. 196 - BROOKLYN","207 BUSHWICK AVENUE"
10,3,7,"ec968d36-30f4-ea11-b882-24ee9a37d45c","P.S. 024 - K024 - K024 - 15K024 - 427 38 STREET","ed968d36-30f4-ea11-b882-24ee9a37d45c",-74004533,40652832,"P.S. 24 - BROOKLYN","427 38 STREET"
4,0,4,"553cbf01-ebf6-ea11-b883-24ee9a37d459","The David Marquis School of the Arts - R037 - R840 - 75R037 - 15 Fairfield Street","81be7adc-32f4-ea11-b882-24ee9a37d45c",-74151368,0,"P.S. 37 ( OLD I24X)-STATEN ISLAND","15 Fairfield Street"
1,0,1,"7907e99e-31f4-ea11-b882-24ee9a37d45c","Art and Design High School - M630 - M488 - 02M630 - 231-249 EAST 56 STREET","6d07e99e-31f4-ea11-b882-24ee9a37d45c",-73967204,40759248,"MIDTOWN EAST CAMPUS - MANHATTAN","231-249 EAST 56 STREET"
3,1,2,"07f32ce2-31f4-ea11-b882-24ee9a37d45c","P.S. 014 Fairview - Q014 - Q014 - 24Q014 - 107-01 OTIS AVENUE","faf22ce2-31f4-ea11-b882-24ee9a37d45c",-73854570,40741020,"P.S. 14 - QUEENS","107-01 OTIS AVENUE"
6,6,0,"9672c880-32f4-ea11-b882-24ee9a37d45c","High School for Construction Trades, Engineering and Architecture - Q650 - Q650 - 27Q650 - 94-06 104TH STREET","8f72c880-32f4-ea11-b882-24ee9a37d45c",-73841475,40689177,"HS FOR CONST.TRADES,ENGG.,& ARCH-Q","94-06 104TH STREET"
6,5,1,"cd8521d0-32f4-ea11-b882-24ee9a37d45c","I.S. 061 William A Morris - R061 - R061 - 31R061 - 445 CASTLETON AVENUE","460410ca-32f4-ea11-b882-24ee9a37d45c",-74097941,40634497,"I.S. 61 - STATEN ISLAND","445 CASTLETON AVENUE"
2,0,2,"aa2ff20c-32f4-ea11-b882-24ee9a37d45c","P.S. 104 The Bays Water - Q104 - Q104 - 27Q104 - 26-01 MOTT AVENUE","3c7eed06-32f4-ea11-b882-24ee9a37d45c",-73764621,40608002,"P.S. 104 - QUEENS","26-01 MOTT AVENUE"
5,3,2,"b03fce93-7c88-ec11-b8d0-24ee9a37d45c","Academy of American Studies - Q575 - Q575 - 30Q575 - 40-11 28th Street","b13fce93-7c88-ec11-b8d0-24ee9a37d45c",-73936596,40751839,"ACADEMY OF AMERICAN STUDIES - QUEENS","40-11 28th Street"
1,1,0,"58a5db98-30f4-ea11-b882-24ee9a37d45c","P.S. 235 Janice Marie Knight School - K235 - K235 - 18K235 - 525 LENOX ROAD","53a5db98-30f4-ea11-b882-24ee9a37d45c",-73940922,40655337,"P.S. 235 - BROOKLYN","525 LENOX ROAD"
2,1,1,"fbce496e-31f4-ea11-b882-24ee9a37d45c","P.S. 128 Audubon - M128 - M128 - 06M128 - 560 WEST 169 STREET","f9ce496e-31f4-ea11-b882-24ee9a37d45c",-73938701,0,"P.S. 128 - MANHATTAN","560 WEST 169 STREET"
1,0,1,"52474313-33f4-ea11-b882-24ee9a37d45c","M.S. X101 Edward R. Byrne - X101 - X101 - 08X101 - 2750 LAFAYETTE AVENUE","4e474313-33f4-ea11-b882-24ee9a37d45c",-73829211,40827080,"I.S. 101 - BRONX","2750 LAFAYETTE AVENUE"
2,1,1,"a32ff20c-32f4-ea11-b882-24ee9a37d45c","P.S. 101 School in the Gardens - Q101 - Q101 - 28Q101 - 2 RUSSELL PLACE","a42ff20c-32f4-ea11-b882-24ee9a37d45c",-73843400,40715543,"P.S. 101 - QUEENS","2 RUSSELL PLACE"
4,0,4,"b332c3fb-eaf6-ea11-b883-24ee9a37d459","Mosaic Pre-K Center - Q331 - Q392 - 24Q331 - 68-20 Myrtle Avenue","a2eb6056-32f4-ea11-b882-24ee9a37d45c",-73883878,0,"PRE-K CENTER @ 68-20 MYRTLE AVENUE - QUEENS","68-20 Myrtle Avenue"
4,4,0,"810e6e25-32f4-ea11-b882-24ee9a37d45c","BELL Academy - Q294 - Q169 - 25Q294 - 18-25 212 STREET","820e6e25-32f4-ea11-b882-24ee9a37d45c",-73778430,0,"P.S. 169 - QUEENS","18-25 212 STREET"
3,2,1,"9083ff9e-30f4-ea11-b882-24ee9a37d45c","P.S. 249 The Caton - K249 - K249 - 17K249 - 18 MARLBOROUGH ROAD","9183ff9e-30f4-ea11-b882-24ee9a37d45c",-73966456,40649509,"P.S. 249 - BROOKLYN","18 MARLBOROUGH ROAD"
3,0,3,"cbe8ce00-32f4-ea11-b882-24ee9a37d45c","I.S. 73 - The Frank Sansivieri Intermediate School - Q073 - Q073 - 24Q073 - 70-02 54 AVENUE","cce8ce00-32f4-ea11-b882-24ee9a37d45c",-73893318,40728558,"I.S. 73 - QUEENS","70-02 54 AVENUE"
2,2,0,"cbd27c6d-30f4-ea11-b882-24ee9a37d45c","P.S. 139 Alexine A. Fenty - K139 - K139 - 22K139 - 330 RUGBY ROAD","cad27c6d-30f4-ea11-b882-24ee9a37d45c",-73965862,40641340,"P.S. 139 - BROOKLYN","330 RUGBY ROAD"
3,0,3,"42e61462-31f4-ea11-b882-24ee9a37d45c","P.S. 096 Joseph Lanzetta - M096 - M096 - 04M096 - 216 EAST 120 STREET","43e61462-31f4-ea11-b882-24ee9a37d45c",-73937179,40799690,"P.S. 96 - MANHATTAN","216 EAST 120 STREET"
4,3,1,"bebfa431-33f4-ea11-b882-24ee9a37d45c","South Bronx Preparatory: A College Board School - X221 - X149 - 07X221 - 360 EAST 145 STREET","bcbfa431-33f4-ea11-b882-24ee9a37d45c",-73920851,40813612,"J.H.S. 149 - BRONX","360 EAST 145 STREET"
3,2,1,"692f77fa-31f4-ea11-b882-24ee9a37d45c","P.S. 063 Old South - Q063 - Q063 - 27Q063 - 90-15 SUTTER AVENUE","6a2f77fa-31f4-ea11-b882-24ee9a37d45c",-73846796,40676978,"P.S. 63 - QUEENS","90-15 SUTTER AVENUE"
7,6,1,"5d07e99e-31f4-ea11-b882-24ee9a37d45c","Stuyvesant High School - M475 - M477 - 02M475 - 345 CHAMBERS STREET","5c07e99e-31f4-ea11-b882-24ee9a37d45c",-74013921,0,"STUYVESANT HS (NEW) - MANHATTAN","345 CHAMBERS STREET"
1,1,0,"4e2b3eee-30f4-ea11-b882-24ee9a37d45c","The Christa McAuliffe School\I.S. 187 - K187 - K486 - 20K187 - 1171 65 STREET","4f2b3eee-30f4-ea11-b882-24ee9a37d45c",-74003883,40627929,"I.S. 187 - BROOKLYN","1171 65 STREET"
2,0,2,"b6689025-33f4-ea11-b882-24ee9a37d45c","P.S. 126 Dr Marjorie H Dunbar - X126 - X126 - 09X126 - 175 WEST 166 STREET","b5689025-33f4-ea11-b882-24ee9a37d45c",-73928200,40835866,"P.S. 126 (ECF) - BRONX","175 WEST 166 STREET"
4,0,4,"30e85c61-30f4-ea11-b882-24ee9a37d45c","P.S. 115 Daniel Mucatel School - K115 - K115 - 18K115 - 1500 East 92 Street","2fe85c61-30f4-ea11-b882-24ee9a37d45c",-73897896,40634861,"P.S. 115 - BROOKLYN","1500 East 92 Street"
2,1,1,"38ff3d8d-33f4-ea11-b882-24ee9a37d45c","P.S. 091 Bronx - X091 - X891 - 10X091 - 2200 AQUEDUCT AVENUE","39ff3d8d-33f4-ea11-b882-24ee9a37d45c",-73907494,40858286,"P.S. 91 MINISCHOOL - BRONX","2200 AQUEDUCT AVENUE"
4,0,4,"3e02fdd0-ebf6-ea11-b883-24ee9a37d459","The Michael J. Petrides School - R080 - R010 - 31R080 - 715 OCEAN TERRACE","4bfdc1bd-32f4-ea11-b882-24ee9a37d45c",-74105883,0,"P.S. 80 (PETRIDES COMPLEX) AF - STATEN ISLAND","715 OCEAN TERRACE"
3,1,2,"15f32ce2-31f4-ea11-b882-24ee9a37d45c","P.S. 018 Winchester - Q018 - Q018 - 26Q018 - 86-35 235 COURT","16f32ce2-31f4-ea11-b882-24ee9a37d45c",-73732290,40731853,"P.S. 18 - QUEENS","86-35 235 COURT"
2,1,1,"ebb98b86-30f4-ea11-b882-24ee9a37d45c","P.S. 194 Raoul Wallenberg - K194 - K194 - 22K194 - 3117 AVENUE W","ecb98b86-30f4-ea11-b882-24ee9a37d45c",-73934163,40598069,"P.S. 194 - BROOKLYN","3117 AVENUE W"
2,1,1,"e09b4c1f-32f4-ea11-b882-24ee9a37d45c","P.S. 153 Maspeth Elem - Q153 - Q153 - 24Q153 - 60-02 60 LANE","e19b4c1f-32f4-ea11-b882-24ee9a37d45c",-73904463,40716296,"P.S. 153 - QUEENS","60-02 60 LANE"
1,0,1,"fd6d3d68-31f4-ea11-b882-24ee9a37d45c","P.S. 138 - M138 - M108 - 75M138 - 1615 MADISON AVENUE","5be61462-31f4-ea11-b882-24ee9a37d45c",-73947855,40795032,"P.S. 108 - MANHATTAN","1615 MADISON AVENUE"
1,0,1,"17af0313-32f4-ea11-b882-24ee9a37d45c","P.S. 134 Hollis - Q134 - Q134 - 29Q134 - 203-02 109 Avenue","10af0313-32f4-ea11-b882-24ee9a37d45c",-73754747,40707535,"P.S. 134 - QUEENS","203-02 109 Avenue"
1,1,0,"78977d2b-32f4-ea11-b882-24ee9a37d45c","J.H.S. 190 Russell Sage - Q190 - Q190 - 28Q190 - 68-17 AUSTIN STREET","75977d2b-32f4-ea11-b882-24ee9a37d45c",-73851700,40723478,"J.H.S. 190 - QUEENS","68-17 AUSTIN STREET"
2,1,1,"13ba8b86-30f4-ea11-b882-24ee9a37d45c","P.S. 206 Joseph F Lamb - K206 - K206 - 22K206 - 2200 GRAVESEND NECK ROAD","14ba8b86-30f4-ea11-b882-24ee9a37d45c",-73948453,0,"P.S. 206 - BROOKLYN","2200 GRAVESEND NECK ROAD"
1,0,1,"0fe63126-ebf6-ea11-b883-24ee9a37d459","P.S. K721 - Brooklyn Occupational Training Center - K721 - K231 - 75K721 - 360 36 STREET","fb21d292-30f4-ea11-b882-24ee9a37d45c",-74005168,40654306,"P.S. 231 - BROOKLYN","360 36 STREET"
8,7,1,"512b3eee-30f4-ea11-b882-24ee9a37d45c","Fort Hamilton High School - K490 - K490 - 20K490 - 8301 SHORE ROAD","522b3eee-30f4-ea11-b882-24ee9a37d45c",-74038103,40626827,"FORT HAMILTON HS - K","8301 SHORE ROAD"
2,0,2,"dfa2f813-ebf6-ea11-b883-24ee9a37d459","P.S. K369 - Coy L. Cox School - K369 - K067 - 75K369 - 51 SAINT EDWARDS STREET","d179df48-30f4-ea11-b882-24ee9a37d45c",-73977674,40695339,"P.S. 67 - BROOKLYN","51 SAINT EDWARDS STREET"
1,1,0,"0fead4e1-d214-ec11-b8b5-24ee9a37d45c","East New York Family Academy - K409 - K599 - 19K409 - 760 Van Siclen Avenue","7b3fd300-d214-ec11-b8b5-24ee9a37d45c",-73886668,40661102,"K599 – East New York","760 Van Siclen Avenue"
2,1,1,"b3fc24e8-31f4-ea11-b882-24ee9a37d45c","P.S. 022 Thomas Jefferson - Q022 - Q022 - 25Q022 - 153-33 SANFORD AVENUE","b1fc24e8-31f4-ea11-b882-24ee9a37d45c",-73811373,40761744,"P.S. 22 - QUEENS","153-33 SANFORD AVENUE"
7,4,3,"f8454b50-32f4-ea11-b882-24ee9a37d45c","P.S. 377 - Q377 - Q335 - 27Q377 - 150-15 RALEIGH STREET","f4454b50-32f4-ea11-b882-24ee9a37d45c",-73836850,0,"Centreville Educational Building","150-15 RALEIGH STREET"
2,2,0,"3a0410ca-32f4-ea11-b882-24ee9a37d45c","P.S. 055 Henry M. Boehm - R055 - R055 - 31R055 - 54 OSBORNE STREET","3b0410ca-32f4-ea11-b882-24ee9a37d45c",-74163037,40536625,"P.S. 55 - STATEN ISLAND","54 OSBORNE STREET"
2,1,1,"b82ff20c-32f4-ea11-b882-24ee9a37d45c","P.S. 108 Captain Vincent G. Fowler - Q108 - Q108 - 27Q108 - 108-10 109 AVENUE","b92ff20c-32f4-ea11-b882-24ee9a37d45c",-73831025,40679083,"P.S. 108 - QUEENS","108-10 109 AVENUE"
2,1,1,"86977d2b-32f4-ea11-b882-24ee9a37d45c","P.S. 193 Alfred J. Kennedy - Q193 - Q193 - 25Q193 - 152-20 11 AVENUE","87977d2b-32f4-ea11-b882-24ee9a37d45c",-73808987,40792053,"P.S. 193 - QUEENS","152-20 11 AVENUE"
2,1,1,"5c2f77fa-31f4-ea11-b882-24ee9a37d45c","P.S. 060 Woodhaven - Q060 - Q060 - 27Q060 - 91-02 88 AVENUE","8e8946f4-31f4-ea11-b882-24ee9a37d45c",-73852792,40691467,"P.S. 60 - QUEENS","91-02 88 AVENUE"
4,4,0,"6707e99e-31f4-ea11-b882-24ee9a37d45c","Talent Unlimited High School - M519 - M480 - 02M519 - 317 EAST 67 STREET","6007e99e-31f4-ea11-b882-24ee9a37d45c",-73959777,40765638,"JULIA RICHMAN ED. COMPLEX - M","317 EAST 67 STREET"
1,1,0,"dc0d3c5b-30f4-ea11-b882-24ee9a37d45c","P.S./I.S. 104 The Fort Hamilton School - K104 - K104 - 20K104 - 9115 5 AVENUE","dd0d3c5b-30f4-ea11-b882-24ee9a37d45c",-74028492,40618077,"P.S. 104 - BROOKLYN","9115 5 AVENUE"
3,0,3,"12ae38fc-7001-ed11-b8db-24ee9a37d45c","The Richard H. Hungerford School - R721 - R086 - 75R721 - 715 L Ocean Terrace","713f38e4-e9e5-ec11-b8d9-24ee9a37d45c",-74108045,40608374,"I.S./H.S. @ 715L OCEAN TERRACE - STATEN ISLAND","715 L Ocean Terrace"
2,0,2,"7ed92255-30f4-ea11-b882-24ee9a37d45c","P.S. 90 Edna Cohen School - K090 - K090 - 21K090 - 2840 WEST 12 STREET","7dd92255-30f4-ea11-b882-24ee9a37d45c",-73980387,40578192,"P.S. 90 - BROOKLYN","2840 WEST 12 STREET"
3,1,2,"ecba3c50-33f4-ea11-b882-24ee9a37d45c","P.S. 340 - X340 - X340 - 10X340 - 25 WEST 195 STREET","edba3c50-33f4-ea11-b882-24ee9a37d45c",-73897171,0,"P.S. 340 - BRONX","25 WEST 195 STREET"
1,0,1,"97dab801-ecf6-ea11-b883-24ee9a37d459","P.S. X721 - Stephen McSweeney School - X721 - X405 - 75X721 - 3000 EAST TREMONT AVENUE","b556635c-33f4-ea11-b882-24ee9a37d45c",-73839583,40839775,"HERBERT H. LEHMAN HS - X","3000 EAST TREMONT AVENUE"
11,4,7,"6ce2635c-32f4-ea11-b882-24ee9a37d45c","Bayside High School - Q495 - Q405 - 26Q495 - 32-24 CORPORAL KENNEDY STREET","6be2635c-32f4-ea11-b882-24ee9a37d45c",-73781041,40771398,"BAYSIDE HS - Q","32-24 CORPORAL KENNEDY STREET"
2,1,1,"f917b7f4-32f4-ea11-b882-24ee9a37d45c","P.S. 396 - X396 - X026 - 10X396 - 1930 ANDREWS AVENUE","e917b7f4-32f4-ea11-b882-24ee9a37d45c",-73913016,40854335,"P.S. 396 - BRONX","1930 ANDREWS AVENUE"
7,5,2,"489d7c62-33f4-ea11-b882-24ee9a37d45c","Astor Collegiate Academy - X299 - X415 - 11X299 - 925 ASTOR AVENUE","439d7c62-33f4-ea11-b882-24ee9a37d45c",-73860729,40860443,"CHRISTOPHER COLUMBUS HS - X","925 ASTOR AVENUE"
2,1,1,"5f6e70b7-31f4-ea11-b882-24ee9a37d45c","High School of Economics and Finance - M489 - M833 - 02M489 - 100 TRINITY PLACE","606e70b7-31f4-ea11-b882-24ee9a37d45c",-74012328,40709270,"HS FOR ECONOMICS & FINANCE - M","100 TRINITY PLACE"
4,3,1,"8341e65b-31f4-ea11-b882-24ee9a37d45c","P.S. 083 Luis Munoz Rivera - M083 - M083 - 04M083 - 219 East 109 Street","8141e65b-31f4-ea11-b882-24ee9a37d45c",-73941955,40793363,"P.S. 83 - MANHATTAN","219 East 109 Street"
2,0,2,"69fdc1bd-32f4-ea11-b882-24ee9a37d45c","P.S. 022 Graniteville - R022 - R022 - 31R022 - 1860 Forest Avenue","6afdc1bd-32f4-ea11-b882-24ee9a37d45c",-74150544,40624847,"P.S. 22 - STATEN ISLAND","1860 Forest Avenue"
1,0,1,"0fa6ba98-31f4-ea11-b882-24ee9a37d45c","University Neighborhood High School - M448 - M446 - 01M448 - 200 Monroe Street","10a6ba98-31f4-ea11-b882-24ee9a37d45c",-73984128,40712269,"UNIVERSITY NEIGHBORHOOD - M","200 Monroe Street"
1,0,1,"5f9f4974-31f4-ea11-b882-24ee9a37d45c","P.S. 154 Harriet Tubman - M154 - M154 - 05M154 - 250 WEST 127 STREET","609f4974-31f4-ea11-b882-24ee9a37d45c",-73948902,40810499,"P.S. 154 - MANHATTAN","250 WEST 127 STREET"
2,2,0,"d8e8ce00-32f4-ea11-b882-24ee9a37d45c","P.S. 079 Francis Lewis - Q079 - Q079 - 25Q079 - 147-27 15 DRIVE","d7e8ce00-32f4-ea11-b882-24ee9a37d45c",-73817338,40786201,"P.S. 79 - QUEENS","147-27 15 DRIVE"
6,4,2,"1e06003e-32f4-ea11-b882-24ee9a37d45c","East-West School of International Studies - Q281 - Q237 - 25Q281 - 46-21 COLDEN STREET","1b06003e-32f4-ea11-b882-24ee9a37d45c",-73821402,0,"J.H.S. 237 - QUEENS","46-21 COLDEN STREET"
8,3,5,"87e2635c-32f4-ea11-b882-24ee9a37d45c","Benjamin N. Cardozo High School - Q415 - Q415 - 26Q415 - 57-00 223RD STREET","86e2635c-32f4-ea11-b882-24ee9a37d45c",-73757271,0,"BENJAMIN N. CARDOZO HS - Q","57-00 223RD STREET"
3,2,1,"08af0313-32f4-ea11-b882-24ee9a37d45c","P.S. 129 Patricia Larkin - Q129 - Q129 - 25Q129 - 128-02 7 Avenue","09af0313-32f4-ea11-b882-24ee9a37d45c",-73839505,40789926,"P.S. 129 - QUEENS","128-02 7 Avenue"
2,2,0,"1eb4977a-32f4-ea11-b882-24ee9a37d45c","Townsend Harris High School - Q525 - Q515 - 25Q525 - 149-11 MELBOURNE AVENUE","1db4977a-32f4-ea11-b882-24ee9a37d45c",-73821532,40737038,"TOWNSEND HARRIS HS - Q","149-11 MELBOURNE AVENUE"
3,0,3,"480b210d-33f4-ea11-b882-24ee9a37d45c","P.S. X811 - X811 - X084 - 75X811 - 1434 Longfellow Avenue","490b210d-33f4-ea11-b882-24ee9a37d45c",-73886798,40830552,"P.S. 811 (OLD I84) - BRONX","1434 Longfellow Avenue"
2,0,2,"78f4a0ef-eaf6-ea11-b883-24ee9a37d459","Sid Miller Academy - K396 - K396 - 75K396 - 110 CHESTER STREET","2d8dbfcf-30f4-ea11-b882-24ee9a37d45c",-73911788,40668232,"P.S. 396 (TANDEM K327-D23)-K","110 CHESTER STREET"
3,2,1,"1c7eed06-32f4-ea11-b882-24ee9a37d45c","P.S. 090 Horace Mann - Q090 - Q090 - 27Q090 - 86-50 109 STREET","1d7eed06-32f4-ea11-b882-24ee9a37d45c",-73839517,40696653,"P.S. 90 - QUEENS","86-50 109 STREET"
1,0,1,"82be7adc-32f4-ea11-b882-24ee9a37d45c","P.S. 65 The Academy of Innovative Learning - R065 - R829 - 31R065 - 98 GRANT STREET","83be7adc-32f4-ea11-b882-24ee9a37d45c",-74078337,0,"ARTHUR D. PHILLIPS SCHOOL - S.I.","98 GRANT STREET"
3,2,1,"27eabc42-30f4-ea11-b882-24ee9a37d45c","M.S. 51 William Alexander - K051 - K051 - 15K051 - 350 5 AVENUE","28eabc42-30f4-ea11-b882-24ee9a37d45c",-73985050,40672358,"I.S. 51 - BROOKLYN","350 5 AVENUE"
2,2,0,"df883319-32f4-ea11-b882-24ee9a37d45c","P.S. 144 Col Jeromus Remsen - Q144 - Q144 - 28Q144 - 69-20 JUNO STREET","e0883319-32f4-ea11-b882-24ee9a37d45c",-73852398,40714890,"P.S. 144 - QUEENS","69-20 JUNO STREET"
2,2,0,"98a9d9c3-32f4-ea11-b882-24ee9a37d45c","P.S. 39 Francis J. Murphy Jr. - R039 - R039 - 31R039 - 99 Macfarland Avenue","99a9d9c3-32f4-ea11-b882-24ee9a37d45c",-74070610,40597824,"P.S. 39 - STATEN ISLAND","99 Macfarland Avenue"
1,1,0,"d38521d0-32f4-ea11-b882-24ee9a37d45c","The Kathleen Grimm School for Leadership and Sustainability - R062 - R062 - 31R062 - 644 Bloomingdale Road","d48521d0-32f4-ea11-b882-24ee9a37d45c",-74217934,0,"K.GRIMM SCL FOR LDRSHP&SUSTAINABLTY@SANDY GR -S.I.","644 Bloomingdale Road"
2,1,1,"75bc9674-32f4-ea11-b882-24ee9a37d45c","Grover Cleveland High School - Q485 - Q485 - 24Q485 - 21-27 HIMROD STREET","74bc9674-32f4-ea11-b882-24ee9a37d45c",-73909202,40711881,"GROVER CLEVELAND HS - Q","21-27 HIMROD STREET"
1,0,1,"26e0d393-ebf6-ea11-b883-24ee9a37d459","P.S. Q233 - Q233 - Q134 - 75Q233 - 203-02 109 Avenue","10af0313-32f4-ea11-b882-24ee9a37d45c",-73754747,40707535,"P.S. 134 - QUEENS","203-02 109 Avenue"
2,1,1,"5e8946f4-31f4-ea11-b882-24ee9a37d45c","P.S. 046 Alley Pond - Q046 - Q046 - 26Q046 - 64-45 218 STREET","5f8946f4-31f4-ea11-b882-24ee9a37d45c",-73758042,40745744,"P.S. 46 - QUEENS","64-45 218 STREET"
1,0,1,"6f283fb1-30f4-ea11-b882-24ee9a37d45c","I.S. 285 Meyer Levin - K285 - K285 - 18K285 - 5909 BEVERLY ROAD","70283fb1-30f4-ea11-b882-24ee9a37d45c",-73920784,40647818,"I.S. 285 - BROOKLYN","5909 BEVERLY ROAD"
2,1,1,"f302cefa-32f4-ea11-b882-24ee9a37d45c","P.S. 032 Belmont - X032 - X032 - 10X032 - 690 EAST 183 STREET","f402cefa-32f4-ea11-b882-24ee9a37d45c",-73886220,40851724,"P.S. 32 - BRONX","690 EAST 183 STREET"
1,0,1,"47474313-33f4-ea11-b882-24ee9a37d45c","Bronx Envision Academy - X511 - X098 - 12X511 - 1619 BOSTON ROAD","3c474313-33f4-ea11-b882-24ee9a37d45c",-73890591,0,"I.S. 98 - BRONX","1619 BOSTON ROAD"
1,1,0,"626e70b7-31f4-ea11-b882-24ee9a37d45c","High School for Environmental Studies - M400 - M834 - 02M400 - 444 WEST 56 STREET","5d6e70b7-31f4-ea11-b882-24ee9a37d45c",-73988610,40767848,"HS FOR ENVIRONMENTAL STUDIES - M","444 WEST 56 STREET"
10,6,4,"692b3eee-30f4-ea11-b882-24ee9a37d45c","Franklin Delano Roosevelt High School - K505 - K505 - 20K505 - 5800 20 AVENUE","682b3eee-30f4-ea11-b882-24ee9a37d45c",-73982583,40621299,"FRANKLIN D. ROOSEVELT HS - K","5800 20 AVENUE"
3,2,1,"16ba8b86-30f4-ea11-b882-24ee9a37d45c","P.S. 207 Elizabeth G. Leary - K207 - K207 - 22K207 - 4011 FILLMORE AVENUE","17ba8b86-30f4-ea11-b882-24ee9a37d45c",-73930485,40613981,"P.S. 207 - BROOKLYN","4011 FILLMORE AVENUE"
2,0,2,"668946f4-31f4-ea11-b882-24ee9a37d45c","P.S. 049 Dorothy Bonawit Kole - Q049 - Q049 - 24Q049 - 63-60 80th Street","678946f4-31f4-ea11-b882-24ee9a37d45c",-73875493,40719567,"P.S./I.S. 49 - QUEENS","63-60 80th Street"
2,0,2,"38e61462-31f4-ea11-b882-24ee9a37d45c","P.S. 092 Mary McLeod Bethune - M092 - M092 - 05M092 - 222 WEST 134 STREET","36e61462-31f4-ea11-b882-24ee9a37d45c",-73945838,40814917,"P.S. 92 - MANHATTAN","222 WEST 134 STREET"
1,1,0,"e417b7f4-32f4-ea11-b882-24ee9a37d45c","Bronx Writing Academy - X323 - X022 - 09X323 - 270 EAST 167 STREET","de17b7f4-32f4-ea11-b882-24ee9a37d45c",-73914350,40832022,"I.S. 22 - BRONX","270 EAST 167 STREET"
5,3,2,"f59b4c1f-32f4-ea11-b882-24ee9a37d45c","P.S. 159 - Q159 - Q159 - 26Q159 - 205-01 33 AVENUE","f69b4c1f-32f4-ea11-b882-24ee9a37d45c",-73783973,40770108,"P.S. 159 - QUEENS","205-01 33 AVENUE"
1,0,1,"632f7d06-31f4-ea11-b882-24ee9a37d45c","Brooklyn's Daily Discovery Pre-K Center - K840 - K787 - 21K840 - 1215 Avenue X","642f7d06-31f4-ea11-b882-24ee9a37d45c",-73958422,0,"PRE-K CENTER @1215 AVENUE X - BROOKLYN","1215 Avenue X"
2,1,1,"c7ba3c50-33f4-ea11-b882-24ee9a37d45c","P.S. 279 Captain Manuel Rivera, Jr. - X279 - X279 - 10X279 - 2100 WALTON AVENUE","c8ba3c50-33f4-ea11-b882-24ee9a37d45c",-73904958,40854666,"P.S. 279 - BRONX","2100 WALTON AVENUE"
5,3,2,"b572c880-32f4-ea11-b882-24ee9a37d45c","P.S. Q016 The Nancy DeBenedittis School - Q016 - Q721 - 24Q016 - 41-15 104 STREET","b672c880-32f4-ea11-b882-24ee9a37d45c",-73860547,40748996,"P.S. 16 (OLD Q721 SPED) - QUEENS","41-15 104 STREET"
1,0,1,"7303194f-30f4-ea11-b882-24ee9a37d45c","P.S. 69 Vincent D. Grippo School - K069 - K069 - 20K069 - 6302 9TH AVENUE","7203194f-30f4-ea11-b882-24ee9a37d45c",-74009752,40632392,"P.S. 69 - BROOKLYN","6302 9TH AVENUE"
1,0,1,"ca85f462-ebf6-ea11-b883-24ee9a37d459","P.S. M811 - Mickey Mantle School - M811 - M149 - 75M811 - 34 West 118 Street","539f4974-31f4-ea11-b882-24ee9a37d45c",-73948088,40802649,"P.S. 149 (TANDEM M207) - MANHATTAN","34 West 118 Street"
3,1,2,"e53159fa-30f4-ea11-b882-24ee9a37d45c","Brooklyn's Daily Discovery Pre-K Center - K840 - K597 - 21K840 - 2202 60th Street","e63159fa-30f4-ea11-b882-24ee9a37d45c",-73978094,0,"EDUCATIONAL CAMPUS @ 2202 60TH STREET","2202 60th Street"
2,0,2,"64a5db98-30f4-ea11-b882-24ee9a37d45c","P.S. K231 - K231 - K238 - 75K231 - 1633 EAST 8 STREET","65a5db98-30f4-ea11-b882-24ee9a37d45c",-73964586,40608801,"P.S. 238 - BROOKLYN","1633 EAST 8 STREET"
3,2,1,"f6d10307-33f4-ea11-b882-24ee9a37d45c","P.S. 072 Dr. William Dorney - X072 - X072 - 08X072 - 2951 DEWEY AVENUE","f4d10307-33f4-ea11-b882-24ee9a37d45c",-73818172,40823237,"P.S. 72 - BRONX","2951 DEWEY AVENUE"
1,1,0,"db2ff20c-32f4-ea11-b882-24ee9a37d45c","P.S. 120 Queens - Q120 - Q120 - 25Q120 - 58-01 136 STREET","dc2ff20c-32f4-ea11-b882-24ee9a37d45c",-73828674,40745215,"P.S. 120 - QUEENS","58-01 136 STREET"
2,0,2,"ca8521d0-32f4-ea11-b882-24ee9a37d45c","P.S. 060 Alice Austen - R060 - R060 - 31R060 - 55 Merrill Avenue","cb8521d0-32f4-ea11-b882-24ee9a37d45c",-74162634,0,"P.S. 60 - STATEN ISLAND","55 Merrill Avenue"
3,2,1,"1de85c61-30f4-ea11-b882-24ee9a37d45c","Achievement First East New York Charter School - K358 - K111 - 84K358 - 35 STARR STREET","18e85c61-30f4-ea11-b882-24ee9a37d45c",-73927938,40700810,"I.S. 111 - BROOKLYN","35 STARR STREET"
2,0,2,"130410ca-32f4-ea11-b882-24ee9a37d45c","CSI High School for International Studies - R047 - R043 - 31R047 - 100 ESSEX DRIVE","a0a9d9c3-32f4-ea11-b882-24ee9a37d45c",-74159343,40581958,"JEROME PARKER CAMPUS - S.I.","100 ESSEX DRIVE"
5,5,0,"63ffcc6e-33f4-ea11-b882-24ee9a37d45c","The Bronx High School of Science - X445 - X445 - 10X445 - 75 WEST 205 STREET","64ffcc6e-33f4-ea11-b882-24ee9a37d45c",-73889011,40879958,"BRONX HS OF SCIENCE - X","75 WEST 205 STREET"
2,1,1,"ffbdf08c-32f4-ea11-b882-24ee9a37d45c","Baccalaureate School for Global Education - Q580 - Q798 - 30Q580 - 34-12 36 AVENUE","00bef08c-32f4-ea11-b882-24ee9a37d45c",-73926977,40754975,"BACCALAUREATE SCL FOR GLOBAL ED-Q","34-12 36 AVENUE"
2,2,0,"ac2aa42b-33f4-ea11-b882-24ee9a37d45c","The New School for Leadership and Journalism - X244 - X143 - 10X244 - 120 WEST 231 STREET","ad2aa42b-33f4-ea11-b882-24ee9a37d45c",-73901565,40875636,"I.S. 143 - BRONX","120 WEST 231 STREET"
1,0,1,"b7b36d80-30f4-ea11-b882-24ee9a37d45c","P.S. K231 - K231 - K180 - 75K231 - 5601 16 AVENUE","b8b36d80-30f4-ea11-b882-24ee9a37d45c",-73989250,40626454,"P.S. 180 - BROOKLYN","5601 16 AVENUE"
3,3,0,"07fc3df4-30f4-ea11-b882-24ee9a37d45c","John Dewey High School - K540 - K540 - 21K540 - 50 AVENUE X","05fc3df4-30f4-ea11-b882-24ee9a37d45c",-73981925,40588070,"JOHN DEWEY HS - K","50 AVENUE X"
1,0,1,"2da198c3-30f4-ea11-b882-24ee9a37d45c","P.S. 345 Patrolman Robert Bolden - K345 - K345 - 19K345 - 111 BERRIMAN STREET","2ca198c3-30f4-ea11-b882-24ee9a37d45c",-73879886,40676207,"P.S. 345 - BROOKLYN","111 BERRIMAN STREET"
1,0,1,"63fdc1bd-32f4-ea11-b882-24ee9a37d45c","P.S. 020 Port Richmond - R020 - R020 - 31R020 - 161 PARK AVENUE","64fdc1bd-32f4-ea11-b882-24ee9a37d45c",-74132382,0,"P.S. 20 - STATEN ISLAND","161 PARK AVENUE"
2,0,2,"4d953aac-ebf6-ea11-b883-24ee9a37d459","District 75 Secondary Site - Q255 (Q397) - S046 - Q397 -  - 32-52 37th Street","a4eb6056-32f4-ea11-b882-24ee9a37d45c",-73920948,40759308,"PRE-K CENTER @37TH STREET - QUEENS","32-52 37th Street"
2,2,0,"d79b4c1f-32f4-ea11-b882-24ee9a37d45c","P.S. 150 Queens - Q150 - Q150 - 30Q150 - 40-01 43 AVENUE","d89b4c1f-32f4-ea11-b882-24ee9a37d45c",-73923375,40745887,"P.S. 150 - QUEENS","40-01 43 AVENUE"
3,1,2,"0678931f-33f4-ea11-b882-24ee9a37d45c","I.S. 117 Joseph H. Wade - X117 - X117 - 09X117 - 1865 MORRIS AVENUE","0578931f-33f4-ea11-b882-24ee9a37d45c",-73909022,40848552,"I.S. 117 - BRONX","1865 MORRIS AVENUE"
1,1,0,"722f77fa-31f4-ea11-b882-24ee9a37d45c","J.H.S. 067 Louis Pasteur - Q067 - Q067 - 26Q067 - 51-60 MARATHON PARKWAY","732f77fa-31f4-ea11-b882-24ee9a37d45c",-73734832,40762241,"J.H.S. 67 - QUEENS","51-60 MARATHON PARKWAY"
2,1,1,"752f77fa-31f4-ea11-b882-24ee9a37d45c","P.S. 068 Cambridge - Q068 - Q068 - 24Q068 - 59-09 SAINT FELIX AVENUE","762f77fa-31f4-ea11-b882-24ee9a37d45c",-73897372,40696961,"P.S. 68 - QUEENS","59-09 SAINT FELIX AVENUE"
6,4,2,"0baf0313-32f4-ea11-b882-24ee9a37d45c","P.S. 130 - Q130 - Q130 - 25Q130 - 200-01 42 AVENUE","04af0313-32f4-ea11-b882-24ee9a37d45c",-73784009,40760219,"P.S. 130 - QUEENS","200-01 42 AVENUE"
2,2,0,"e7883319-32f4-ea11-b882-24ee9a37d45c","P.S. 146 Howard Beach - Q146 - Q146 - 27Q146 - 98-01 159 AVENUE","e8883319-32f4-ea11-b882-24ee9a37d45c",-73834896,40660531,"P.S. 146 - QUEENS","98-01 159 AVENUE"
1,0,1,"2768ee1e-31f4-ea11-b882-24ee9a37d45c","P.S. 209 Margaret Mead - K209 - K941 - 21K209 - 2609 EAST 7 STREET","2868ee1e-31f4-ea11-b882-24ee9a37d45c",-73961191,40586800,"P.S. 209 TRANSPORTABLE - K","2609 EAST 7 STREET"
2,2,0,"d5ab074a-33f4-ea11-b882-24ee9a37d45c","The School of Science and Applied Learning - X300 - X234 - 12X300 - 2050 PROSPECT AVENUE","d4ab074a-33f4-ea11-b882-24ee9a37d45c",-73886721,40846128,"P.S. 234 (PAIRED W I129) - BRONX","2050 PROSPECT AVENUE"
2,0,2,"4a416e00-31f4-ea11-b882-24ee9a37d45c","Brooklyn's Daily Discovery Pre-K Center - K840 - K687 - 21K840 - 10 BOUCK COURT","4b416e00-31f4-ea11-b882-24ee9a37d45c",-73973728,40588759,"PRE-K CENTER @BOUCK COURT - BROOKLYN","10 BOUCK COURT"
1,0,1,"286e3d68-31f4-ea11-b882-24ee9a37d45c","P.S. 333 Manhattan School for Children - M333 - M118 - 03M333 - 154 WEST 93 STREET","246e3d68-31f4-ea11-b882-24ee9a37d45c",-73971011,40791395,"I.S. 118 - MANHATTAN","154 WEST 93 STREET"
1,0,1,"433cbf01-ebf6-ea11-b883-24ee9a37d459","P.S. Q811 - Q811 - Q811 - 75Q811 - 61-25 MARATHON PARKWAY","08bef08c-32f4-ea11-b882-24ee9a37d45c",-73728412,40756481,"P.S. 811 (OLD 187) - QUEENS","61-25 MARATHON PARKWAY"
2,2,0,"418dbfcf-30f4-ea11-b882-24ee9a37d45c","Kingsborough Early College School - K468 - K400 - 21K468 - 2630 BENSON AVENUE","3a8dbfcf-30f4-ea11-b882-24ee9a37d45c",-73986313,40593028,"Lafayette Educational Campus","2630 BENSON AVENUE"
3,0,3,"e38521d0-32f4-ea11-b882-24ee9a37d45c","I.S. 072 Rocco Laurie - R072 - R072 - 31R072 - 33 FERNDALE AVENUE","e48521d0-32f4-ea11-b882-24ee9a37d45c",-74158618,0,"I.S. 72 - STATEN ISLAND","33 FERNDALE AVENUE"
1,0,1,"87e03d56-33f4-ea11-b882-24ee9a37d45c","School for Excellence - X404 - X400 - 09X404 - 1110 BOSTON ROAD","82e03d56-33f4-ea11-b882-24ee9a37d45c",-73903920,40827455,"MORRIS HS - X","1110 BOSTON ROAD"
3,3,0,"c0e0838c-31f4-ea11-b882-24ee9a37d45c","East Side Elementary School, PS 267 - M267 - M267 - 02M267 - 213 EAST 63RD STREET","c1e0838c-31f4-ea11-b882-24ee9a37d45c",-73963861,40763883,"P.S. 59 - (MEETH) -MANHATTAN","213 EAST 63RD STREET"
3,3,0,"c5fab455-31f4-ea11-b882-24ee9a37d45c","East Side Community School - M450 - M060 - 01M450 - 420 East 12 Street","c1fab455-31f4-ea11-b882-24ee9a37d45c",-73982472,40729152,"J.H.S. 60 - MANHATTAN","420 East 12 Street"
4,2,2,"e0e0838c-31f4-ea11-b882-24ee9a37d45c","P.S. 051 Elias Howe - M051 - M338 - 02M051 - 525 WEST 44TH STREET","dfe0838c-31f4-ea11-b882-24ee9a37d45c",-73995825,40761487,"P.S. 51 ELIAS HOWE - MANHATTAN","525 WEST 44TH STREET"
1,0,1,"44953aac-ebf6-ea11-b883-24ee9a37d459","P.S. Q233 - Q233 - Q335 - 75Q233 - 150-15 RALEIGH STREET","f4454b50-32f4-ea11-b882-24ee9a37d45c",-73836850,0,"Centreville Educational Building","150-15 RALEIGH STREET"
3,1,2,"1cba8b86-30f4-ea11-b882-24ee9a37d45c","P.S. 209 Margaret Mead - K209 - K209 - 21K209 - 2609 EAST 7 STREET","1dba8b86-30f4-ea11-b882-24ee9a37d45c",-73961191,40586800,"P.S. 209 - BROOKLYN","2609 EAST 7 STREET"
2,2,0,"652f77fa-31f4-ea11-b882-24ee9a37d45c","P. S. 62 - Chester Park School - Q062 - Q062 - 27Q062 - 97-25 108 STREET","642f77fa-31f4-ea11-b882-24ee9a37d45c",-73835567,40688359,"P.S. 62 - QUEENS","97-25 108 STREET"
1,1,0,"18b7c337-32f4-ea11-b882-24ee9a37d45c","Waterside School For Leadership - Q318 - Q225 - 27Q318 - 190 BEACH 110 STREET","19b7c337-32f4-ea11-b882-24ee9a37d45c",-73831090,0,"P.S. 225 - QUEENS","190 BEACH 110 STREET"
1,0,1,"4fa10a44-32f4-ea11-b882-24ee9a37d45c","P.S./I.S. 268 - Q268 - Q268 - 29Q268 - 92-07 175 STREET","4ea10a44-32f4-ea11-b882-24ee9a37d45c",-73785210,40707648,"P.S. 268 - QUEENS","92-07 175 STREET"
4,4,0,"77c280bd-31f4-ea11-b882-24ee9a37d45c","The Clinton School - M260 - M868 - 02M260 - 10 East 15th Street","78c280bd-31f4-ea11-b882-24ee9a37d45c",-73992727,0,"THE CLINTON SCHOOL - MANHATTAN","10 East 15th Street"
1,1,0,"b669c231-32f4-ea11-b882-24ee9a37d45c","P.S. 209 Clearview Gardens - Q209 - Q209 - 25Q209 - 16-10 Utopia Parkway","b569c231-32f4-ea11-b882-24ee9a37d45c",-73795845,40783777,"P.S. 209 - QUEENS","16-10 Utopia Parkway"
2,0,2,"8c72c880-32f4-ea11-b882-24ee9a37d45c","Thomas A. Edison Career and Technical Education High School - Q620 - Q620 - 28Q620 - 165-65 84 AVENUE","49b4977a-32f4-ea11-b882-24ee9a37d45c",-73799692,40716071,"THOMAS A. EDISON VOC HS - Q","165-65 84 AVENUE"
3,2,1,"aefc24e8-31f4-ea11-b882-24ee9a37d45c","P.S. 021 Edward Hart - Q021 - Q021 - 25Q021 - 147-36 26 AVENUE","adfc24e8-31f4-ea11-b882-24ee9a37d45c",-73818581,40774134,"P.S. 21 - QUEENS","147-36 26 AVENUE"
2,2,0,"8a41e65b-31f4-ea11-b882-24ee9a37d45c","P.S. 084 Lillian Weber - M084 - M084 - 03M084 - 32 West 92 Street","8b41e65b-31f4-ea11-b882-24ee9a37d45c",-73968419,40789479,"P.S. 84 - MANHATTAN","32 West 92 Street"
1,0,1,"cee0838c-31f4-ea11-b882-24ee9a37d45c","The River School - M281 - M281 - 02M281 - 425 East 35 Street","cde0838c-31f4-ea11-b882-24ee9a37d45c",-73972592,40744288,"P.S. 281 - MANHATTAN","425 East 35 Street"
1,1,0,"03b7c337-32f4-ea11-b882-24ee9a37d45c","J.H.S. 216 George J. Ryan - Q216 - Q216 - 26Q216 - 64-20 175 Street","04b7c337-32f4-ea11-b882-24ee9a37d45c",-73794501,40737188,"J.H.S. 216 - QUEENS","64-20 175 Street"
1,0,1,"3d474313-33f4-ea11-b882-24ee9a37d45c","P.S. 096 Richard Rodgers - X096 - X096 - 11X096 - 2385 OLINVILLE AVENUE","3e474313-33f4-ea11-b882-24ee9a37d45c",-73868986,40860730,"P.S. 96 - BRONX","2385 OLINVILLE AVENUE"
1,0,1,"e29319d7-ebf6-ea11-b883-24ee9a37d459","The Richmond Pre-K Center - R066 - R113 - 31R066 - 841 FATHER CAPODANNO BOULEVARD","f98521d0-32f4-ea11-b882-24ee9a37d45c",-74083885,40575592,"3K CENTER @ FATHER CAPODANNO BOULEVARD - STATEN IS","841 FATHER CAPODANNO BOULEVARD"
4,3,1,"410b210d-33f4-ea11-b882-24ee9a37d45c","P.S. 081 Robert J. Christen - X081 - X081 - 10X081 - 5550 RIVERDALE AVENUE","420b210d-33f4-ea11-b882-24ee9a37d45c",-73904657,40903275,"P.S. 81 - BRONX","5550 RIVERDALE AVENUE"
2,0,2,"8b11b2e2-32f4-ea11-b882-24ee9a37d45c","Staten Island School of Civic Leadership - R861 - R861 - 31R861 - 280 REGIS DRIVE","8a11b2e2-32f4-ea11-b882-24ee9a37d45c",-74164427,40620310,"ELIZABETH A. CONNELLY CAMPUS - S.I.","280 REGIS DRIVE"
1,0,1,"4f3cbf01-ebf6-ea11-b883-24ee9a37d459","The Richmond Pre-K Center - R066 - R077 - 31R066 - 120 STUYVESANT PLACE","e98521d0-32f4-ea11-b882-24ee9a37d45c",-74076955,0,"PRE-K CENTER @ 120 STUYVESANT PLACE - S.I.","120 STUYVESANT PLACE"
1,1,0,"12a31781-33f4-ea11-b882-24ee9a37d45c","The Bronx STEM and Arts Academy - X051 - X781 - 10X051 - 695 East 182nd Street","13a31781-33f4-ea11-b882-24ee9a37d45c",-73886997,40850674,"P.S. 51 - BRONX","695 East 182nd Street"
5,0,5,"61507380-31f4-ea11-b882-24ee9a37d45c","P.S. 189 - M189 - M189 - 06M189 - 2580 AMSTERDAM AVENUE","5f507380-31f4-ea11-b882-24ee9a37d45c",-73928048,40853045,"P.S. 189 - MANHATTAN","2580 AMSTERDAM AVENUE"
2,1,1,"f7d27c6d-30f4-ea11-b882-24ee9a37d45c","P.S. 153 Homecrest - K153 - K153 - 21K153 - 1970 HOMECREST AVENUE","f8d27c6d-30f4-ea11-b882-24ee9a37d45c",-73960027,40601179,"P.S. 153 - BROOKLYN","1970 HOMECREST AVENUE"
2,2,0,"57ebaa73-30f4-ea11-b882-24ee9a37d45c","Ralph A. Fabrizio School - K170 - K170 - 20K170 - 619 72ND STREET","58ebaa73-30f4-ea11-b882-24ee9a37d45c",-74018719,40630373,"P.S. 170 - BROOKLYN","619 72ND STREET"
3,3,0,"e292e6d5-30f4-ea11-b882-24ee9a37d45c","James Madison High School - K425 - K425 - 22K425 - 3787 BEDFORD AVENUE","e092e6d5-30f4-ea11-b882-24ee9a37d45c",-73947661,40610499,"JAMES MADISON HS - K","3787 BEDFORD AVENUE"
2,1,1,"369f4974-31f4-ea11-b882-24ee9a37d45c","Manhattan Charter School - M320 - M142 - 84M320 - 100 ATTORNEY STREET","379f4974-31f4-ea11-b882-24ee9a37d45c",-73984116,40718121,"P.S. 142 - MANHATTAN","100 ATTORNEY STREET"
3,1,2,"69edfc72-4afb-ea11-b883-24ee9a37d459","OUR SAVIOUR LUTHERAN - QAXQ - QAXQ -  - 90-04 175TH STREET","6aedfc72-4afb-ea11-b883-24ee9a37d459",-73786925,40709647,"OUR SAVIOUR LUTHERAN","90-04 175TH STREET"
1,0,1,"56767649-31f4-ea11-b882-24ee9a37d45c","P.S. 042 Benjamin Altman - M042 - M042 - 02M042 - 71 HESTER STREET","51767649-31f4-ea11-b882-24ee9a37d45c",-73990826,40716126,"P.S. 42 - MANHATTAN","71 HESTER STREET"
2,2,0,"d4f57030-30f4-ea11-b882-24ee9a37d45c","The Emily Warren Roebling School - K008 - K008 - 13K008 - 37 HICKS STREET","d5f57030-30f4-ea11-b882-24ee9a37d45c",-73992841,40700709,"P.S. 8 - BROOKLYN","37 HICKS STREET"
1,0,1,"e2e0a4fb-ebf6-ea11-b883-24ee9a37d459","P.S. X010 - X010 - X240 - 75X010 - 1501 JEROME AVENUE","baba3c50-33f4-ea11-b882-24ee9a37d45c",-73916084,40842503,"DOE NEW SETTLEMENT COMMUNITY CAMPUS - X","1501 JEROME AVENUE"
1,1,0,"cd315367-30f4-ea11-b882-24ee9a37d45c","P.S. 127 Mckinley Park - K127 - K127 - 20K127 - 7805 7 Avenue","ce315367-30f4-ea11-b882-24ee9a37d45c",-74018429,40623687,"P.S. 127 - BROOKLYN","7805 7 Avenue"
2,1,1,"4a9d7c62-33f4-ea11-b882-24ee9a37d45c","Bronxdale High School - X508 - X415 - 11X508 - 925 ASTOR AVENUE","439d7c62-33f4-ea11-b882-24ee9a37d45c",-73860729,40860443,"CHRISTOPHER COLUMBUS HS - X","925 ASTOR AVENUE"
3,2,1,"6c8946f4-31f4-ea11-b882-24ee9a37d45c","P.S. 051 - Q051 - Q051 - 27Q051 - 87-45 117 STREET","6d8946f4-31f4-ea11-b882-24ee9a37d45c",-73831532,40698286,"P.S. 51 (ECC) - QUEENS","87-45 117 STREET"
1,0,1,"e9e0a4fb-ebf6-ea11-b883-24ee9a37d459","P.S. X721 - Stephen McSweeney School - X721 - X368 - 75X721 - 2975 TIBBETT AVENUE","74e03d56-33f4-ea11-b882-24ee9a37d45c",-73913694,40877935,"M.S./H.S. 368 - BRONX","2975 TIBBETT AVENUE"
2,0,2,"01f32ce2-31f4-ea11-b882-24ee9a37d45c","P.S. 012 James B. Colgate - Q012 - Q012 - 24Q012 - 42-00 72 STREET","02f32ce2-31f4-ea11-b882-24ee9a37d45c",-73893466,0,"P.S. 12 - QUEENS","42-00 72 STREET"
1,1,0,"f9ae0313-32f4-ea11-b882-24ee9a37d45c","P.S. 124 Osmond A Church - Q124 - Q124 - 27Q124 - 129-15 150 AVENUE","faae0313-32f4-ea11-b882-24ee9a37d45c",-73811266,40665669,"P.S. 124 - QUEENS","129-15 150 AVENUE"
3,3,0,"e68521d0-32f4-ea11-b882-24ee9a37d45c","I.S. 075 Frank D. Paulo - R075 - R075 - 31R075 - 455 HUGUENOT AVENUE","e28521d0-32f4-ea11-b882-24ee9a37d45c",-74197033,40544535,"I.S. 75 - STATEN ISLAND","455 HUGUENOT AVENUE"
1,0,1,"307eed06-32f4-ea11-b882-24ee9a37d45c","P.S. 097 Forest Park - Q097 - Q097 - 27Q097 - 85-52 85 STREET","317eed06-32f4-ea11-b882-24ee9a37d45c",-73860031,40694232,"P.S. 97 - QUEENS","85-52 85 STREET"
1,1,0,"43767649-31f4-ea11-b882-24ee9a37d45c","P.S. 033 Chelsea Prep - M033 - M033 - 02M033 - 281 9 AVENUE","42767649-31f4-ea11-b882-24ee9a37d45c",-74000238,40749014,"P.S. 33 - MANHATTAN","281 9 AVENUE"
1,0,1,"6ba5db98-30f4-ea11-b882-24ee9a37d45c","Mark Twain I.S. 239 for the Gifted & Talented - K239 - K239 - 21K239 - 2401 NEPTUNE AVENUE","6ca5db98-30f4-ea11-b882-24ee9a37d45c",-73992447,40578640,"I.S. 239 - BROOKLYN","2401 NEPTUNE AVENUE"
5,5,0,"b779df48-30f4-ea11-b882-24ee9a37d45c","P.S. 058 The Carroll - K058 - K058 - 15K058 - 330 SMITH STREET","b879df48-30f4-ea11-b882-24ee9a37d45c",-73995486,0,"P.S. 58 - BROOKLYN","330 SMITH STREET"
3,2,1,"9241e65b-31f4-ea11-b882-24ee9a37d45c","Wadleigh Secondary School for the Performing & Visual Arts - M415 - M088 - 03M415 - 215 WEST 114 STREET","8841e65b-31f4-ea11-b882-24ee9a37d45c",-73954152,40802610,"I.S. 88 - MANHATTAN","215 WEST 114 STREET"
1,1,0,"68f4a0ef-eaf6-ea11-b883-24ee9a37d459","P.S. K811 Connie Lekas School - K811 - K286 - 75K811 - 2525 HARING STREET","6e283fb1-30f4-ea11-b882-24ee9a37d45c",-73938610,40591132,"P.S. 811 (OLD P286) - BROOKLYN","2525 HARING STREET"
1,1,0,"445bc58c-30f4-ea11-b882-24ee9a37d45c","P.S. 212 Lady Deborah Moody - K212 - K212 - 21K212 - 87 BAY 49 STREET","455bc58c-30f4-ea11-b882-24ee9a37d45c",-73985368,40587612,"P.S. 212 - BROOKLYN","87 BAY 49 STREET"
1,1,0,"bec88e4f-31f4-ea11-b882-24ee9a37d45c","M.S. M247 Dual Language Middle School - M247 - M044 - 03M247 - 100 WEST 77 STREET","bfc88e4f-31f4-ea11-b882-24ee9a37d45c",-73977602,40780536,"I.S. 44 - MANHATTAN","100 WEST 77 STREET"
2,1,1,"db11f898-32f4-ea11-b882-24ee9a37d45c","Robert F. Wagner, Jr. Secondary School for Arts and Technology - Q560 - Q891 - 24Q560 - 47-07 30th Place","d911f898-32f4-ea11-b882-24ee9a37d45c",-73936442,40742217,"R. F. WAGNER SEC SCL ARTS & TECH-Q","47-07 30th Place"
2,1,1,"532f7d06-31f4-ea11-b882-24ee9a37d45c","District 20 Pre-K Center - K768 - K767 - 20K768 - 1668 46th Street","542f7d06-31f4-ea11-b882-24ee9a37d45c",-73982211,40631776,"PRE-K CENTER @1668 46TH STREET, BROOKLYN, NY 11204","1668 46th Street"
2,1,1,"3e7c21b7-32f4-ea11-b882-24ee9a37d45c","P.S. 005 Huguenot - R005 - R005 - 31R005 - 348 DEISIUS STREET","3f7c21b7-32f4-ea11-b882-24ee9a37d45c",-74187276,40529389,"P.S. 5 - STATEN ISLAND","348 DEISIUS STREET"
1,0,1,"bae0838c-31f4-ea11-b882-24ee9a37d45c","P.S. 234 Independence School - M234 - M234 - 02M234 - 292 GREENWICH STREET","bbe0838c-31f4-ea11-b882-24ee9a37d45c",-74010880,40719530,"P.S. 234 - MANHATTAN","292 GREENWICH STREET"
4,3,1,"20eabc42-30f4-ea11-b882-24ee9a37d45c","J.H.S. 050 John D. Wells - K050 - K050 - 14K050 - 183 SOUTH 3 STREET","1feabc42-30f4-ea11-b882-24ee9a37d45c",-73960137,40711915,"J.H.S. 50 - BROOKLYN","183 SOUTH 3 STREET"
1,0,1,"84f4a0ef-eaf6-ea11-b883-24ee9a37d459","The Joan Snow Pre-K Center - K853 - K765 - 22K853 - 1139 Coney Island Avenue","4f2f7d06-31f4-ea11-b882-24ee9a37d45c",-73966208,0,"PRE-K CENTER @1139 CONEY ISLAND AVENUE - BROOKLYN","1139 Coney Island Avenue"
2,1,1,"9069c231-32f4-ea11-b882-24ee9a37d45c","Robert H. Goddard High School of Communication Arts and Technology - Q308 - Q202 - 27Q308 - 138-30 LAFAYETTE STREET","9169c231-32f4-ea11-b882-24ee9a37d45c",-73845992,0,"I.S. 202 - QUEENS","138-30 LAFAYETTE STREET"
3,2,1,"ed17b7f4-32f4-ea11-b882-24ee9a37d45c","P.S. 024 Spuyten Duyvil - X024 - X024 - 10X024 - 660 WEST 236 STREET","ee17b7f4-32f4-ea11-b882-24ee9a37d45c",-73915114,40886922,"P.S. 24 - BRONX","660 WEST 236 STREET"
1,1,0,"0dd1de79-30f4-ea11-b882-24ee9a37d45c","P.S. 177 The Marlboro - K177 - K177 - 21K177 - 346 AVENUE P","0ed1de79-30f4-ea11-b882-24ee9a37d45c",-73974425,40608169,"P.S. 177 - BROOKLYN","346 AVENUE P"
6,2,4,"10b7c337-32f4-ea11-b882-24ee9a37d45c","P.S. 221 The North Hills School - Q221 - Q221 - 26Q221 - 57-40 MARATHON PARKWAY","11b7c337-32f4-ea11-b882-24ee9a37d45c",-73731518,0,"P.S. 221 - QUEENS","57-40 MARATHON PARKWAY"
1,0,1,"c617ab87-ebf6-ea11-b883-24ee9a37d459","P.S. Q233 - Q233 - Q025 - 75Q233 - 34-65 192 STREET","befc24e8-31f4-ea11-b882-24ee9a37d45c",-73789365,0,"J.H.S. 25 - QUEENS","34-65 192 STREET"
2,2,0,"0918b7f4-32f4-ea11-b882-24ee9a37d45c","P.S. 030 Wilton - X030 - X030 - 07X030 - 510 EAST 141 STREET","0118b7f4-32f4-ea11-b882-24ee9a37d45c",-73917417,0,"P.S. 30 - BRONX","510 EAST 141 STREET"
1,1,0,"e79319d7-ebf6-ea11-b883-24ee9a37d459","The Richard H. Hungerford School - R721 - R435 - 75R721 - 465 NEW DORP LANE","fb8521d0-32f4-ea11-b882-24ee9a37d45c",-74105878,40570909,"NEW DORP HS (NEW) - S. I.","465 NEW DORP LANE"
1,1,0,"26c73b4a-32f4-ea11-b882-24ee9a37d45c","A.C.E. Academy for Scholars at the Geraldine Ferraro Campus - Q290 - Q290 - 24Q290 - 55-20 METROPOLITAN AVENUE","24c73b4a-32f4-ea11-b882-24ee9a37d45c",-73908307,40713030,"THE GERALDINE FERRARO CAMPUS - QUEENS","55-20 METROPOLITAN AVENUE"
2,1,1,"fbcaf33e-6f01-ed11-b8db-24ee9a37d45c","Mosaic Pre-K Center - Q331 - Q369 - 24Q331 - 46-01 111th Street","96ccad4f-f81e-eb11-b885-24ee9a37d45c",-73843333,0,"PRE-K CENTER @ 111TH STREET - QUEENS","46-01 111th Street"
2,0,2,"e0d10307-33f4-ea11-b882-24ee9a37d45c","P.S. 066 School of Higher Expectations - X066 - X066 - 12X066 - 1001 JENNINGS STREET","ded10307-33f4-ea11-b882-24ee9a37d45c",-73886540,40831493,"P.S. 66 - BRONX","1001 JENNINGS STREET"
3,3,0,"417c21b7-32f4-ea11-b882-24ee9a37d45c","P.S. 6 Corporal Allan F. Kivlehan School - R006 - R006 - 31R006 - 555 PAGE AVENUE","3c7c21b7-32f4-ea11-b882-24ee9a37d45c",-74230118,0,"P.S. 6 - STATEN ISLAND","555 PAGE AVENUE"
1,0,1,"dac88e4f-31f4-ea11-b882-24ee9a37d45c","P.S. 048 P.O. Michael J. Buczek - M048 - M048 - 06M048 - 4360-78 BROADWAY","d9c88e4f-31f4-ea11-b882-24ee9a37d45c",-73933629,40853193,"P.S. 48 - MANHATTAN","4360-78 BROADWAY"
1,1,0,"dd92e6d5-30f4-ea11-b882-24ee9a37d45c","Spring Creek Community School - K422 - K422 - 19K422 - 1065 Elton Street","da92e6d5-30f4-ea11-b882-24ee9a37d45c",-73874064,40657266,"SPRING CREEK EDUCATIONAL CAMPUS - BROOKLYN","1065 Elton Street"
1,1,0,"9969c231-32f4-ea11-b882-24ee9a37d45c","J.H.S. 202 Robert H. Goddard - Q202 - Q202 - 27Q202 - 138-30 LAFAYETTE STREET","9169c231-32f4-ea11-b882-24ee9a37d45c",-73845992,0,"I.S. 202 - QUEENS","138-30 LAFAYETTE STREET"
2,2,0,"17c73b4a-32f4-ea11-b882-24ee9a37d45c","P.S. 182 Samantha Smith - Q182 - Q277 - 28Q182 - 153-27 88th Avenue","15c73b4a-32f4-ea11-b882-24ee9a37d45c",-73803183,40706750,"PS 182 SAMANTHA SMITH - QUEENS","153-27 88th Avenue"
7,2,5,"240b210d-33f4-ea11-b882-24ee9a37d45c","P.S. 076 The Bennington School - X076 - X076 - 11X076 - 900 ADEE AVENUE","250b210d-33f4-ea11-b882-24ee9a37d45c",-73860928,40869059,"P.S. 76 - BRONX","900 ADEE AVENUE"
6,4,2,"c7e0838c-31f4-ea11-b882-24ee9a37d45c","Battery Park City School - M276 - M276 - 02M276 - 55 BATTERY PLACE","c6e0838c-31f4-ea11-b882-24ee9a37d45c",-74017456,40706384,"P.S./I.S. 276 - MANHATTAN","55 BATTERY PLACE"
1,0,1,"da2ece86-32f4-ea11-b882-24ee9a37d45c","High School of Applied Communication - Q267 - Q735 - 24Q267 - 30-20 THOMSON AVENUE","db2ece86-32f4-ea11-b882-24ee9a37d45c",-73937004,0,"QUEENS HIGH SCHOOL COMPLEX - Q","30-20 THOMSON AVENUE"
3,2,1,"90bc9674-32f4-ea11-b882-24ee9a37d45c","Hillcrest High School - Q505 - Q505 - 28Q505 - 160-05 HIGHLAND AVENUE","8fbc9674-32f4-ea11-b882-24ee9a37d45c",-73803001,0,"HILLCREST HS - Q","160-05 HIGHLAND AVENUE"
1,0,1,"f2c1392a-30f4-ea11-b882-24ee9a37d45c","P.S. 005 Dr. Ronald McNair - K005 - K005 - 16K005 - 820 HANCOCK STREET","edc1392a-30f4-ea11-b882-24ee9a37d45c",-73921970,40685241,"P.S. 5 - BROOKLYN","820 HANCOCK STREET"
2,0,2,"6107e99e-31f4-ea11-b882-24ee9a37d45c","Ella Baker School - M225 - M480 - 02M225 - 317 EAST 67 STREET","6007e99e-31f4-ea11-b882-24ee9a37d45c",-73959777,40765638,"JULIA RICHMAN ED. COMPLEX - M","317 EAST 67 STREET"
1,0,1,"89476368-32f4-ea11-b882-24ee9a37d45c","District 25 Pre-K Center - Q409 - Q454 - 25Q409 - 123-07 22nd Avenue","8a476368-32f4-ea11-b882-24ee9a37d45c",-73844811,40780363,"PRE-K CENTER @22ND AVENUE - QUEENS","123-07 22nd Avenue"
1,0,1,"1b474313-33f4-ea11-b882-24ee9a37d45c","Sheridan Academy for Young Leaders - X457 - X090 - 09X457 - 1116 SHERIDAN AVENUE","1c474313-33f4-ea11-b882-24ee9a37d45c",-73917526,0,"P.S. 90 - BRONX","1116 SHERIDAN AVENUE"
1,1,0,"ef201dab-30f4-ea11-b882-24ee9a37d45c","M.S. 442 Carroll Gardens School for Innovation - K442 - K280 - 15K442 - 500 19 STREET","ed201dab-30f4-ea11-b882-24ee9a37d45c",-73983116,40656952,"PRE-K CENTER @ 500 19TH STREET - BROOKLYN","500 19 STREET"
2,1,1,"f6f57030-30f4-ea11-b882-24ee9a37d45c","P.S. 015 Patrick F. Daly - K015 - K015 - 15K015 - 71 SULLIVAN STREET","f5f57030-30f4-ea11-b882-24ee9a37d45c",-74011864,40677085,"P.S. 15 - BROOKLYN","71 SULLIVAN STREET"
3,2,1,"858d8486-31f4-ea11-b882-24ee9a37d45c","P.S. 199 Jessie Isador Straus - M199 - M199 - 03M199 - 270 WEST 70 STREET","868d8486-31f4-ea11-b882-24ee9a37d45c",-73984423,40777603,"P.S. 199 - MANHATTAN","270 WEST 70 STREET"
3,2,1,"6e36d900-33f4-ea11-b882-24ee9a37d45c","P.S. 056 Norwood Heights - X056 - X056 - 10X056 - 341 EAST 207 STREET","6f36d900-33f4-ea11-b882-24ee9a37d45c",-73874912,40875481,"P.S. 56 - BRONX","341 EAST 207 STREET"
3,0,3,"ad32c3fb-eaf6-ea11-b883-24ee9a37d459","P.S. Q993 - Q993 - Q191 - 75Q993 - 85-15 258 STREET","7b977d2b-32f4-ea11-b882-24ee9a37d45c",-73708617,40734266,"P.S. 191 - QUEENS","85-15 258 STREET"
3,3,0,"52507380-31f4-ea11-b882-24ee9a37d45c","P.S. 183 Robert L. Stevenson - M183 - M183 - 02M183 - 419 East 66 Street","53507380-31f4-ea11-b882-24ee9a37d45c",-73957731,40763804,"P.S. 183 - MANHATTAN","419 East 66 Street"
2,2,0,"2e005d7a-31f4-ea11-b882-24ee9a37d45c","Mott Hall II - M862 - M165 - 03M862 - 234 West 109 Street","2f005d7a-31f4-ea11-b882-24ee9a37d45c",-73965949,40802653,"P.S. 165 - MANHATTAN","234 West 109 Street"
2,2,0,"f1d10307-33f4-ea11-b882-24ee9a37d45c","P.S. 071 Rose E. Scala - X071 - X071 - 08X071 - 3040 ROBERTS AVENUE","e3d10307-33f4-ea11-b882-24ee9a37d45c",-73829562,40845379,"P.S. 71 - BRONX","3040 ROBERTS AVENUE"
2,1,1,"882aa42b-33f4-ea11-b882-24ee9a37d45c","P186X Walter J. Damrosch School - X186 - X136 - 75X186 - 750 Jennings Street","892aa42b-33f4-ea11-b882-24ee9a37d45c",-73897797,40831388,"P.S. 186 (OLD J136) - BRONX","750 Jennings Street"
2,2,0,"380d6d19-33f4-ea11-b882-24ee9a37d45c","P.S. 105 Sen Abraham Bernstein - X105 - X105 - 11X105 - 725 Brady Avenue","390d6d19-33f4-ea11-b882-24ee9a37d45c",-73866264,40853075,"P.S. 105 - BRONX","725 Brady Avenue"
2,1,1,"d4e8ce00-32f4-ea11-b882-24ee9a37d45c","P.S. 076 William Hallet - Q076 - Q076 - 30Q076 - 36-36 10 Street","d2e8ce00-32f4-ea11-b882-24ee9a37d45c",-73941630,40760862,"P.S. 76 - QUEENS","36-36 10 Street"
1,1,0,"68507380-31f4-ea11-b882-24ee9a37d45c","P.S. 452 - M452 - M191 - 03M452 - 210 WEST 61 STREET","69507380-31f4-ea11-b882-24ee9a37d45c",-73987515,40771603,"P.S. 191 - MANHATTAN","210 WEST 61 STREET"
1,0,1,"aeab074a-33f4-ea11-b882-24ee9a37d45c","P.S. 211 - X211 - X193 - 12X211 - 1919 PROSPECT AVENUE","afab074a-33f4-ea11-b882-24ee9a37d45c",-73890145,40843705,"P.S. 211 - BRONX","1919 PROSPECT AVENUE"
3,2,1,"b68442ee-31f4-ea11-b882-24ee9a37d45c","P.S. 026 Rufus King - Q026 - Q026 - 26Q026 - 195-02 69 AVENUE","c5fc24e8-31f4-ea11-b882-24ee9a37d45c",-73777607,40735935,"P.S. 26 - QUEENS","195-02 69 AVENUE"
1,1,0,"9553dd74-33f4-ea11-b882-24ee9a37d45c","University Heights Secondary School - X495 - X470 - 07X495 - 701 ST. ANNS AVENUE","9253dd74-33f4-ea11-b882-24ee9a37d45c",-73911633,40818041,"SOUTH BRONX EDUCATIONAL CAMPUS (OLD 38) - X","701 ST. ANNS AVENUE"
1,1,0,"674accc4-ebf6-ea11-b883-24ee9a37d459","P.S. Q255 - Q255 - Q885 - 75Q255 - 35-59 81ST STREET","d511f898-32f4-ea11-b882-24ee9a37d45c",-73884817,40749934,"RENAISSANCE CHARTER SCHOOL - Q","35-59 81ST STREET"
1,1,0,"e880b5c9-df1e-eb11-b885-24ee9a37d45c","MS 936 Arts Off 3rd - K936 - K746 - 20K936 - 270 59th Street","e980b5c9-df1e-eb11-b885-24ee9a37d45c",-74020748,0,"P.S. @ 270 59TH STREET- BROOKLYN","270 59th Street"
3,2,1,"e96a212b-8e3d-eb11-b88a-24ee9a37d45c","Queens Pointe Talent, Inc. - QBDB - QBLT -  - 90-02 Queens Boulevard","ea6a212b-8e3d-eb11-b88a-24ee9a37d45c",-73872405,40734076,"Queens Pointe Children's Center","90-02 Queens Boulevard"
7,7,0,"ace657bd-30f4-ea11-b882-24ee9a37d45c","P.S. 321 William Penn - K321 - K321 - 15K321 - 180 7 AVENUE","ade657bd-30f4-ea11-b882-24ee9a37d45c",-73978633,40671816,"P.S. 321 - BROOKLYN","180 7 AVENUE"
2,1,1,"ef9b4c1f-32f4-ea11-b882-24ee9a37d45c","J.H.S. 157 Stephen A. Halsey - Q157 - Q157 - 28Q157 - 63-55 102ND STREET","f09b4c1f-32f4-ea11-b882-24ee9a37d45c",-73852879,40732348,"J.H.S. 157 - QUEENS","63-55 102ND STREET"
1,1,0,"a1476368-32f4-ea11-b882-24ee9a37d45c","Flushing Evening High Schl M/W - Q901 - Q460 - 25Q901 - 35-01 UNION STREET","97476368-32f4-ea11-b882-24ee9a37d45c",-73826811,40764892,"FLUSHING HS - Q","35-01 UNION STREET"
1,1,0,"ca92e6d5-30f4-ea11-b882-24ee9a37d45c","Academy of Innovative Technology - K618 - K420 - 19K618 - 999 JAMAICA AVENUE","c692e6d5-30f4-ea11-b882-24ee9a37d45c",-73869305,40693002,"FRANKLIN K. LANE HS - K","999 JAMAICA AVENUE"
1,1,0,"57042f6f-ebf6-ea11-b883-24ee9a37d459","Success Academy Charter School - Harlem 1 - M351 - M620 - 84M351 - 111 EAST 33RD STREET","a0d810ab-31f4-ea11-b882-24ee9a37d45c",-73981070,40746510,"NORMAN THOMAS HS (ECF) - MANHATTAN","111 EAST 33RD STREET"
1,1,0,"92283fb1-30f4-ea11-b882-24ee9a37d45c","Success Academy Charter School - Cobble Hill - K129 - K293 - 84K129 - 284 Baltic Street","91283fb1-30f4-ea11-b882-24ee9a37d45c",-73993293,40685006,"J.H.S. 293 - BROOKLYN","284 Baltic Street"
4,0,4,"270410ca-32f4-ea11-b882-24ee9a37d45c","The Eagle Academy for Young Men of Staten Island - R028 - R049 - 31R028 - 101 WARREN STREET","190410ca-32f4-ea11-b882-24ee9a37d45c",-74080695,0,"I.S. 49 - STATEN ISLAND","101 WARREN STREET"
1,0,1,"8a03194f-30f4-ea11-b882-24ee9a37d45c","Success Academy Charter School - Bergen Beach - K781 - K078 - 84K781 - 1420 EAST 68 STREET","8b03194f-30f4-ea11-b882-24ee9a37d45c",-73912914,0,"I.S. 78 - BROOKLYN","1420 EAST 68 STREET"
2,1,1,"35ebaa73-30f4-ea11-b882-24ee9a37d45c","P.S. 164 Caesar Rodney - K164 - K164 - 20K164 - 4211 14 AVENUE","36ebaa73-30f4-ea11-b882-24ee9a37d45c",-73985739,40637101,"P.S. 164 - BROOKLYN","4211 14 AVENUE"
2,2,0,"f29b4c1f-32f4-ea11-b882-24ee9a37d45c","M.S. 158 Marie Curie - Q158 - Q158 - 26Q158 - 46-35 Oceania Street","f39b4c1f-32f4-ea11-b882-24ee9a37d45c",-73771878,40756562,"J.H.S. 158 - QUEENS","46-35 Oceania Street"
2,1,1,"a948b1f5-eaf6-ea11-b883-24ee9a37d459","Success Academy Charter School - Harlem 1 - M351 - M149 - 84M351 - 34 West 118 Street","539f4974-31f4-ea11-b882-24ee9a37d45c",-73948088,40802649,"P.S. 149 (TANDEM M207) - MANHATTAN","34 West 118 Street"
1,0,1,"0922d292-30f4-ea11-b882-24ee9a37d45c","New American Academy Charter School - K736 - K233 - 84K736 - 9301 AVENUE B","0a22d292-30f4-ea11-b882-24ee9a37d45c",-73914282,40651642,"P.S. 233 - BROOKLYN","9301 AVENUE B"
3,3,0,"167eed06-32f4-ea11-b882-24ee9a37d45c","P.S. 088 Seneca - Q088 - Q088 - 24Q088 - 60-85 CATALPA AVENUE","177eed06-32f4-ea11-b882-24ee9a37d45c",-73896437,40704105,"P.S. 88 - QUEENS","60-85 CATALPA AVENUE"
1,1,0,"9548b1f5-eaf6-ea11-b883-24ee9a37d459","Brooklyn Navy Yard STEAM Center - K891 - K777 - 33K891 - 141 FLUSHING AVENUE","5a2f7d06-31f4-ea11-b882-24ee9a37d45c",-73972767,40702258,"H.S. STEAM CENTER@BUILDING 77 - BROOKLYN","141 FLUSHING AVENUE"
2,1,1,"62be7adc-32f4-ea11-b882-24ee9a37d45c","Ralph R. McKee Career and Technical Education High School - R600 - R600 - 31R600 - 101 Belmont Place","5ebe7adc-32f4-ea11-b882-24ee9a37d45c",-74079263,40642820,"RALPH MCKEE VOC HS - S. I.","101 Belmont Place"
1,0,1,"30ebaa73-30f4-ea11-b882-24ee9a37d45c","Success Academy Charter School - Crown Heights - K741 - K161 - 84K741 - 330 CROWN STREET","31ebaa73-30f4-ea11-b882-24ee9a37d45c",-73949243,40665757,"P.S. 161 - BROOKLYN","330 CROWN STREET"
1,1,0,"eace496e-31f4-ea11-b882-24ee9a37d45c","P.S. 124 Yung Wing - M124 - M124 - 02M124 - 40 DIVISION STREET","e8ce496e-31f4-ea11-b882-24ee9a37d45c",-73996017,40715097,"P.S. 124 (ECF) - MANHATTAN","40 DIVISION STREET"
1,0,1,"7da9d9c3-32f4-ea11-b882-24ee9a37d45c","P.S. 030 Westerleigh - R030 - R030 - 31R030 - 200 Wardwell Avenue","73a9d9c3-32f4-ea11-b882-24ee9a37d45c",-74133080,0,"P.S. 30 - STATEN ISLAND","200 Wardwell Avenue"
3,0,3,"58507380-31f4-ea11-b882-24ee9a37d45c","P.S./I.S. 187 Hudson Cliffs - M187 - M187 - 06M187 - 349 CABRINI BOULEVARD","59507380-31f4-ea11-b882-24ee9a37d45c",-73936840,40856239,"P.S./I.S. 187 - MANHATTAN","349 CABRINI BOULEVARD"
4,2,2,"6541e65b-31f4-ea11-b882-24ee9a37d45c","New York City Lab Middle School for Collaborative Studies - M312 - M070 - 02M312 - 333 WEST 17 STREET","defab455-31f4-ea11-b882-24ee9a37d45c",-74002222,40742512,"I.S. 70 - MANHATTAN","333 WEST 17 STREET"
2,1,1,"45e61462-31f4-ea11-b882-24ee9a37d45c","Bard High School Early College - M696 - M097 - 01M696 - 525 EAST HOUSTON STREET","46e61462-31f4-ea11-b882-24ee9a37d45c",-73976093,40718276,"BARD COLLEGE HS (OLD M097) - M","525 EAST HOUSTON STREET"
1,0,1,"d9883319-32f4-ea11-b882-24ee9a37d45c","P.S. 143 Louis Armstrong - Q143 - Q143 - 24Q143 - 34-74 113 Street","d7883319-32f4-ea11-b882-24ee9a37d45c",-73855715,40755393,"P.S. 143 - QUEENS","34-74 113 Street"
2,2,0,"179ebaee-32f4-ea11-b882-24ee9a37d45c","Milton Fein School - X007 - X007 - 10X007 - 3201 KINGSBRIDGE AVENUE","189ebaee-32f4-ea11-b882-24ee9a37d45c",-73905697,40881562,"P.S. 7 - BRONX","3201 KINGSBRIDGE AVENUE"
2,2,0,"629d7c62-33f4-ea11-b882-24ee9a37d45c","The Cinema School - X478 - X423 - 12X478 - 1551 EAST 172ND STREET","639d7c62-33f4-ea11-b882-24ee9a37d45c",-73878191,40832508,"JAMES MONROE HS CAMPUS ANNEX - BRONX","1551 EAST 172ND STREET"
1,0,1,"422f7d06-31f4-ea11-b882-24ee9a37d45c","P.S. 245 - K245 - K735 - 22K245 - 249 EAST 17TH STREET","432f7d06-31f4-ea11-b882-24ee9a37d45c",-73962743,40644927,"P.S. 245 - BROOKLYN","249 EAST 17TH STREET"
13,10,3,"d90d3c5b-30f4-ea11-b882-24ee9a37d45c","P.S. 102 The Bayview - K102 - K102 - 20K102 - 211 72 STREET","da0d3c5b-30f4-ea11-b882-24ee9a37d45c",-74028758,40634318,"P.S. 102 - BROOKLYN","211 72 STREET"
1,1,0,"a132c3fb-eaf6-ea11-b883-24ee9a37d459","P.S. 085 Judge Charles Vallone - Q085 - Q085 - 30Q085 - 23-70 31 STREET","0a7eed06-32f4-ea11-b882-24ee9a37d45c",-73915039,40773126,"P.S. 85 - QUEENS","23-70 31 STREET"
2,1,1,"8407e99e-31f4-ea11-b882-24ee9a37d45c","Manhattan / Hunter Science High School - M541 - M490 - 03M541 - 122 AMSTERDAM AVENUE","7c07e99e-31f4-ea11-b882-24ee9a37d45c",-73985608,40774891,"MARTIN LUTHER KING, JR. HS - M","122 AMSTERDAM AVENUE"
2,1,1,"b49c11e8-30f4-ea11-b882-24ee9a37d45c","The Brooklyn School for Math and Research - K168 - K480 - 32K168 - 400 IRVING AVENUE","b39c11e8-30f4-ea11-b882-24ee9a37d45c",-73911751,40696457,"BUSHWICK EDUCATIONAL CAMPUS - K","400 IRVING AVENUE"
6,4,2,"d6968d36-30f4-ea11-b882-24ee9a37d45c","Brooklyn Arbor Elementary School - K414 - K019 - 14K414 - 325 SOUTH 3 STREET","d7968d36-30f4-ea11-b882-24ee9a37d45c",-73954678,40710107,"P.S. 19 - BROOKLYN","325 SOUTH 3 STREET"
1,1,0,"45507380-31f4-ea11-b882-24ee9a37d45c","Muscota - M314 - M176 - 06M314 - 4862 BROADWAY","46507380-31f4-ea11-b882-24ee9a37d45c",-73923818,40866381,"P.S./I.S. 176 - MANHATTAN","4862 BROADWAY"
3,2,1,"1878931f-33f4-ea11-b882-24ee9a37d45c","P.S. 310 Marble Hill - X310 - X122 - 10X310 - 260 W KINGSBRIDGE RD","1978931f-33f4-ea11-b882-24ee9a37d45c",-73905547,40872477,"P.S. 310 - BRONX","260 W KINGSBRIDGE RD"
1,1,0,"d53159fa-30f4-ea11-b882-24ee9a37d45c","George Westinghouse Career and Technical Education High School - K605 - K580 - 13K605 - 105 TECH PLACE","d33159fa-30f4-ea11-b882-24ee9a37d45c",-73986105,40695444,"GEORGE WESTINGHOUSE VOC HS - K","105 TECH PLACE"
1,0,1,"2fff3d8d-33f4-ea11-b882-24ee9a37d45c","Community School for Social Justice - X427 - X884 - 07X427 - 350 Gerard Avenue","2dff3d8d-33f4-ea11-b882-24ee9a37d45c",-73929960,40815712,"HEALTH OPPORTUNITIES HS - X","350 Gerard Avenue"
1,1,0,"fa201dab-30f4-ea11-b882-24ee9a37d45c","P.S. 282 Park Slope - K282 - K282 - 13K282 - 180 6 Avenue","f8201dab-30f4-ea11-b882-24ee9a37d45c",-73977983,40676649,"P.S. 282 - BROOKLYN","180 6 Avenue"
1,1,0,"8f0e6e25-32f4-ea11-b882-24ee9a37d45c","P.S. 173 Fresh Meadows - Q173 - Q173 - 26Q173 - 174-10 67 AVENUE","900e6e25-32f4-ea11-b882-24ee9a37d45c",-73795651,40734097,"P.S. 173 - QUEENS","174-10 67 AVENUE"
2,2,0,"81eb6056-32f4-ea11-b882-24ee9a37d45c","The Woodside Community School - Q361 - Q339 - 30Q361 - 39-07 57th Street","82eb6056-32f4-ea11-b882-24ee9a37d45c",-73906430,0,"P.S. 339 - Queens","39-07 57th Street"
1,0,1,"afeb6056-32f4-ea11-b882-24ee9a37d45c","New Visions Charter High School for Advanced Math and Science IV - Q320 - Q400 - 84Q320 - 156-10 BAISLEY BOULEVARD","a9eb6056-32f4-ea11-b882-24ee9a37d45c",-73782684,40673949,"AUGUST MARTIN HS - QUEENS","156-10 BAISLEY BOULEVARD"
1,0,1,"e7968d36-30f4-ea11-b882-24ee9a37d45c","P.S. 023 Carter G. Woodson - K023 - K023 - 14K023 - 545 WILLOUGHBY AVENUE","e5968d36-30f4-ea11-b882-24ee9a37d45c",-73947256,40694470,"P.S. 23 - BROOKLYN","545 WILLOUGHBY AVENUE"
3,2,1,"46b4977a-32f4-ea11-b882-24ee9a37d45c","Aviation Career & Technical Education High School - Q610 - Q610 - 24Q610 - 45-30 36 STREET","44b4977a-32f4-ea11-b882-24ee9a37d45c",-73929577,40743309,"AVIATION HS - Q","45-30 36 STREET"
1,0,1,"26e79768-7301-ed11-b8db-24ee9a37d45c","Garden of Learning and Discovery Pre-K Center - X582 - X497 - 09X582 - 4197 3 Avenue","27e79768-7301-ed11-b8db-24ee9a37d45c",-73897376,40846206,"3K Center @ 4197 Third Avenue","4197 3 Avenue"
3,2,1,"378dbfcf-30f4-ea11-b882-24ee9a37d45c","P.S. 770 New American Academy - K770 - K398 - 17K770 - 60 EAST 94 STREET","308dbfcf-30f4-ea11-b882-24ee9a37d45c",-73927979,40663388,"P.S. 398 (UDC) - BROOKLYN","60 EAST 94 STREET"
1,1,0,"15a6ba98-31f4-ea11-b882-24ee9a37d45c","Gramercy Arts High School - M374 - M460 - 02M374 - 40 IRVING PLACE","16a6ba98-31f4-ea11-b882-24ee9a37d45c",-73987064,40735361,"WASHINGTON IRVING HS - MANHATTAN","40 IRVING PLACE"
1,1,0,"ec201dab-30f4-ea11-b882-24ee9a37d45c","Pre-K Center at Bishop Ford School Site - K863 - K280 - 15K863 - 500 19 STREET","ed201dab-30f4-ea11-b882-24ee9a37d45c",-73983116,40656952,"PRE-K CENTER @ 500 19TH STREET - BROOKLYN","500 19 STREET"
1,1,0,"5d2f7d06-31f4-ea11-b882-24ee9a37d45c","El Puente Academy for Peace and Justice - K685 - K778 - 14K685 - 250 Hooper Street","5e2f7d06-31f4-ea11-b882-24ee9a37d45c",-73955741,40705540,"EL PUENTE HS - BROOKLYN","250 Hooper Street"
2,1,1,"83e03d56-33f4-ea11-b882-24ee9a37d45c","Morris Academy for Collaborative Studies - X297 - X400 - 09X297 - 1110 BOSTON ROAD","82e03d56-33f4-ea11-b882-24ee9a37d45c",-73903920,40827455,"MORRIS HS - X","1110 BOSTON ROAD"
1,1,0,"58e61462-31f4-ea11-b882-24ee9a37d45c","P.S. 102 Jacques Cartier - M102 - M102 - 04M102 - 315 EAST 113 STREET","56e61462-31f4-ea11-b882-24ee9a37d45c",-73938418,40795000,"P.S. 102 - MANHATTAN","315 EAST 113 STREET"
1,1,0,"43416e00-31f4-ea11-b882-24ee9a37d45c","District 20 Pre-K Center - K768 - K664 - 20K768 - 140 58th Street","44416e00-31f4-ea11-b882-24ee9a37d45c",-74022864,40645338,"PRE-K CENTER @ 58TH STREET - BROOKLYN","140 58th Street"
3,2,1,"555b4cd6-32f4-ea11-b882-24ee9a37d45c","Port Richmond High School - R445 - R445 - 31R445 - 85 ST JOSEPHS AVENUE","515b4cd6-32f4-ea11-b882-24ee9a37d45c",-74141924,40635562,"PORT RICHMOND HS - S. I.","85 ST JOSEPHS AVENUE"
3,3,0,"7f283fb1-30f4-ea11-b882-24ee9a37d45c","P.S. 290 Juan Morel Campos - K290 - K290 - 19K290 - 135 Schenck Avenue","7e283fb1-30f4-ea11-b882-24ee9a37d45c",-73889375,40678182,"P.S. 290 - BROOKLYN","135 Schenck Avenue"
2,0,2,"fbfb3df4-30f4-ea11-b882-24ee9a37d45c","Edward R. Murrow High School - K525 - K525 - 21K525 - 1600 AVENUE L","fafb3df4-30f4-ea11-b882-24ee9a37d45c",-73959141,0,"EDWARD R. MURROW HS - K","1600 AVENUE L"
1,1,0,"d3315367-30f4-ea11-b882-24ee9a37d45c","P.S. 130 The Parkside - K130 - K130 - 15K130 - 70 Ocean Parkway","cc315367-30f4-ea11-b882-24ee9a37d45c",-73976053,40648924,"P.S. 130 - BROOKLYN","70 Ocean Parkway"
1,1,0,"fa11a0be-ebf6-ea11-b883-24ee9a37d459","P.S. Q224 - Q224 - Q809 - 75Q224 - 221-21 Corbett Road","febdf08c-32f4-ea11-b882-24ee9a37d45c",-73763295,40770666,"P.S. 224 ANNEX - QUEENS","221-21 Corbett Road"
2,1,1,"9b53dd74-33f4-ea11-b882-24ee9a37d45c","Bronx School of Law and Finance - X284 - X475 - 10X284 - 99 TERRACE VIEW AVENUE","9853dd74-33f4-ea11-b882-24ee9a37d45c",-73912686,40877379,"JOHN F. KENNEDY HS - X","99 TERRACE VIEW AVENUE"
3,3,0,"7dc280bd-31f4-ea11-b882-24ee9a37d45c","Manhattan Village Academy - M439 - M873 - 02M439 - 43 WEST 22 STREET","7ec280bd-31f4-ea11-b882-24ee9a37d45c",-73991966,40741963,"MANHATTAN VILLAGE ACADEMY - M","43 WEST 22 STREET"
1,1,0,"81886843-31f4-ea11-b882-24ee9a37d45c","P.S. 003 Charrette School - M003 - M003 - 02M003 - 490 HUDSON STREET","82886843-31f4-ea11-b882-24ee9a37d45c",-74005949,40732603,"P.S. 3 - MANHATTAN","490 HUDSON STREET"
1,0,1,"c6b66262-32f4-ea11-b882-24ee9a37d45c","Business Technology Early College High School - Q315 - Q435 - 26Q315 - 230-17 HILLSIDE AVENUE","c4b66262-32f4-ea11-b882-24ee9a37d45c",-73739726,0,"MARTIN VAN BUREN HS - QUEENS","230-17 HILLSIDE AVENUE"
5,3,2,"b6315367-30f4-ea11-b882-24ee9a37d45c","P.S. 120 Carlos Tapia - K120 - K120 - 14K120 - 18 Beaver Street","b2315367-30f4-ea11-b882-24ee9a37d45c",-73937888,40700819,"P.S. 120 - BROOKLYN","18 Beaver Street"
2,2,0,"e78442ee-31f4-ea11-b882-24ee9a37d45c","P.S. 041 Crocheron - Q041 - Q041 - 26Q041 - 214-43 35 AVENUE","e58442ee-31f4-ea11-b882-24ee9a37d45c",-73771225,40770155,"P.S. 41 - QUEENS","214-43 35 AVENUE"
1,1,0,"f0f22ce2-31f4-ea11-b882-24ee9a37d45c","York Early College Academy - Q284 - Q008 - 28Q284 - 108-35 167 STREET","f1f22ce2-31f4-ea11-b882-24ee9a37d45c",-73786403,0,"J.H.S. 8 - QUEENS","108-35 167 STREET"
1,1,0,"6ca9d9c3-32f4-ea11-b882-24ee9a37d45c","I.S. 024 Myra S. Barnes - R024 - R024 - 31R024 - 750 DURANT AVENUE","5bfdc1bd-32f4-ea11-b882-24ee9a37d45c",-74145558,40545490,"I.S. 24 - STATEN ISLAND","750 DURANT AVENUE"
1,1,0,"72e2635c-32f4-ea11-b882-24ee9a37d45c","District 25 Pre-K Center - Q409 - Q409 - 25Q409 - 14-45 143rd Street","73e2635c-32f4-ea11-b882-24ee9a37d45c",-73826154,0,"DDC UPK CENTER @143RD STREET - QUEENS","14-45 143rd Street"
2,2,0,"aafc24e8-31f4-ea11-b882-24ee9a37d45c","P.S. 020 John Bowne - Q020 - Q020 - 25Q020 - 142-30 BARCLAY AVENUE","14f32ce2-31f4-ea11-b882-24ee9a37d45c",-73824388,40758347,"P.S. 20 - QUEENS","142-30 BARCLAY AVENUE"
4,1,3,"b9b66262-32f4-ea11-b882-24ee9a37d45c","John Bowne High School - Q425 - Q425 - 25Q425 - 63-25 MAIN STREET","bab66262-32f4-ea11-b882-24ee9a37d45c",-73823841,40737448,"JOHN BOWNE HS - QUEENS","63-25 MAIN STREET"
1,0,1,"9a778cb8-ebf6-ea11-b883-24ee9a37d459","P.S. Q993 - Q993 - Q499 - 75Q993 - 148-20 REEVES AVENUE","8bbc9674-32f4-ea11-b882-24ee9a37d45c",-73820821,0,"P.S./I.S. 499 - QUEENS","148-20 REEVES AVENUE"
1,0,1,"534e22b0-2718-ed11-b09b-088e901ef405","The Riverview School - Q277 - Q419 - 75Q277 - 111-10 Astoria Boulevard","71e5bc26-6c0c-ed11-b091-088e901ef405",-73858714,0,"Tommie Agee Educational Campus","111-10 Astoria Boulevard"
4,3,1,"47a10a44-32f4-ea11-b882-24ee9a37d45c","P.S./I.S. 295 - Q295 - Q263 - 29Q295 - 222-14 JAMAICA AVENUE","41a10a44-32f4-ea11-b882-24ee9a37d45c",-73731398,40720617,"P.S. /I.S 295 - QUEENS","222-14 JAMAICA AVENUE"
1,0,1,"a70e6e25-32f4-ea11-b882-24ee9a37d45c","P.S. 181 Brookfield - Q181 - Q181 - 29Q181 - 148-15 230 Street","a80e6e25-32f4-ea11-b882-24ee9a37d45c",-73752948,40655674,"P.S. 181 - QUEENS","148-15 230 Street"
1,0,1,"434f56b6-80ef-eb11-b8b1-24ee9a37d45c","P.S. 36 - K036 - K208 - 75K036 - 4801 AVENUE D","1aba8b86-30f4-ea11-b882-24ee9a37d45c",-73930898,40642700,"P.S. 208 - BROOKLYN","4801 AVENUE D"
1,0,1,"766bdf9e-49fb-ea11-b883-24ee9a37d459","CARMEN MORENO - APT2K - XBML - XBML -  - 2170 UNIVERSITY AVENUE","776bdf9e-49fb-ea11-b883-24ee9a37d459",-73908905,40857805,"2170 UNIVERSITY AVENUE","2170 UNIVERSITY AVENUE"
1,0,1,"1168ee1e-31f4-ea11-b882-24ee9a37d45c","P.S. 373 - Brooklyn Transition Center - K373 - K909 - 75K373 - 561 GRAND AVENUE","1268ee1e-31f4-ea11-b882-24ee9a37d45c",-73961636,40678591,"ACORN COMMUNITY HS - K","561 GRAND AVENUE"
1,1,0,"462f7d06-31f4-ea11-b882-24ee9a37d45c","District 20 Pre-K Center - K768 - K747 - 20K768 - 21 Bay 11th Street","472f7d06-31f4-ea11-b882-24ee9a37d45c",-74008608,0,"PRE-K CENTER @ 21 BAY 11TH STREET - BROOKLYN","21 Bay 11th Street"
1,0,1,"a5eb6056-32f4-ea11-b882-24ee9a37d45c","District 30 Pre-K Center - Q389 - Q397 - 30Q389 - 32-52 37th Street","a4eb6056-32f4-ea11-b882-24ee9a37d45c",-73920948,40759308,"PRE-K CENTER @37TH STREET - QUEENS","32-52 37th Street"
4,2,2,"40b4977a-32f4-ea11-b882-24ee9a37d45c","Queens Technical High School - Q600 - Q600 - 24Q600 - 37-02 47 AVENUE","41b4977a-32f4-ea11-b882-24ee9a37d45c",-73927995,40741658,"QUEENS VOC HS - Q","37-02 47 AVENUE"
1,1,0,"70977d2b-32f4-ea11-b882-24ee9a37d45c","J.H.S. 189 Daniel Carter Beard - Q189 - Q189 - 25Q189 - 144-80 BARCLAY AVENUE","6b977d2b-32f4-ea11-b882-24ee9a37d45c",-73818399,40759963,"J.H.S. 189 - QUEENS","144-80 BARCLAY AVENUE"
3,1,2,"840e6e25-32f4-ea11-b882-24ee9a37d45c","P.S. 169 Bay Terrace - Q169 - Q169 - 25Q169 - 18-25 212 STREET","820e6e25-32f4-ea11-b882-24ee9a37d45c",-73778430,0,"P.S. 169 - QUEENS","18-25 212 STREET"
1,0,1,"40953aac-ebf6-ea11-b883-24ee9a37d459","The Riverview School - Q277 - Q322 - 75Q277 - 89-11 43rd Avenue","ec454b50-32f4-ea11-b882-24ee9a37d45c",-73876706,40742891,"PS 14 Annex","89-11 43rd Avenue"
1,1,0,"a5edf392-32f4-ea11-b882-24ee9a37d45c","Joseph F. Quinn Intermediate School 77 - Q077 - Q849 - 24Q077 - 976 Seneca Avenue","a4edf392-32f4-ea11-b882-24ee9a37d45c",-73902147,40699101,"I.S. 77 - QUEENS","976 Seneca Avenue"
1,0,1,"95778cb8-ebf6-ea11-b883-24ee9a37d459","The Riverview School - Q277 - Q485 - 75Q277 - 21-27 HIMROD STREET","74bc9674-32f4-ea11-b882-24ee9a37d45c",-73909202,40711881,"GROVER CLEVELAND HS - Q","21-27 HIMROD STREET"
1,0,1,"94283fb1-30f4-ea11-b882-24ee9a37d45c","Digital Arts and Cinema Technology High School - K429 - K293 - 15K429 - 284 Baltic Street","91283fb1-30f4-ea11-b882-24ee9a37d45c",-73993293,40685006,"J.H.S. 293 - BROOKLYN","284 Baltic Street"
1,0,1,"d6d27c6d-30f4-ea11-b882-24ee9a37d45c","P.S. 145 Andrew Jackson - K145 - K145 - 32K145 - 100 NOLL STREET","d7d27c6d-30f4-ea11-b882-24ee9a37d45c",-73932388,40701107,"P.S. 145 - BROOKLYN","100 NOLL STREET"
3,2,1,"53ffcc6e-33f4-ea11-b882-24ee9a37d45c","World View High School - X353 - X440 - 10X353 - 100 WEST MOSHOLU PARKWAY SOUTH","4cffcc6e-33f4-ea11-b882-24ee9a37d45c",-73889011,40879958,"DEWITT CLINTON HS - X","100 WEST MOSHOLU PARKWAY SOUTH"
1,1,0,"e3c4bd60-4afb-ea11-b883-24ee9a37d459","EVBO, INC. DBA JACK & JILL NURSERY SCHOOL - QATU - QATU -  - 43-23 COLDEN STREET","e4c4bd60-4afb-ea11-b883-24ee9a37d459",-73824913,40752470,"EVBO, INC. DBA JACK & JILL NURSERY SCHOOL","43-23 COLDEN STREET"
1,0,1,"51953aac-ebf6-ea11-b883-24ee9a37d459","The Riverview School - Q277 - Q404 - 75Q277 - 1-50 51ST AVENUE","65e2635c-32f4-ea11-b882-24ee9a37d45c",-73959183,0,"HUNTERS POINT CAMPUS - QUEENS","1-50 51ST AVENUE"
2,1,1,"7953dd74-33f4-ea11-b882-24ee9a37d45c","Bronx Bridges High School - X432 - X450 - 08X432 - 1980 LAFAYETTE AVENUE","62ffcc6e-33f4-ea11-b882-24ee9a37d45c",-73855930,40821218,"Adlai E. Stevenson Educational Campus","1980 LAFAYETTE AVENUE"
2,1,1,"673cbf01-ebf6-ea11-b883-24ee9a37d459","P.S. X596 - X596 - X178 - 75X596 - 850 BAYCHESTER AVENUE","e38a0044-33f4-ea11-b882-24ee9a37d45c",-73831669,0,"P.S. 178 - BRONX","850 BAYCHESTER AVENUE"
2,2,0,"d0ed94c3-31f4-ea11-b882-24ee9a37d45c","Leadership and Public Service High School - M425 - M894 - 02M425 - 90 TRINITY PLACE","d1ed94c3-31f4-ea11-b882-24ee9a37d45c",-74012465,0,"HS FOR LEADERSHIP & PUBLIC SER - M","90 TRINITY PLACE"
2,1,1,"0a9c4c1f-32f4-ea11-b882-24ee9a37d45c","P.S. 165 Edith K. Bergtraum - Q165 - Q165 - 25Q165 - 70-35 150 Street","0b9c4c1f-32f4-ea11-b882-24ee9a37d45c",-73816966,40729746,"P.S. 165 - QUEENS","70-35 150 Street"
1,0,1,"1c1a397a-49fb-ea11-b883-24ee9a37d459","ANGELA POTTINGER - - QBSF - QBSF -  - 227-46 113 AVENUE","1d1a397a-49fb-ea11-b883-24ee9a37d459",-73728578,0,"227-46 113 AVENUE","227-46 113 AVENUE"
1,1,0,"d7f57030-30f4-ea11-b882-24ee9a37d45c","Public School 9 The Sarah Smith Garnet School - K009 - K009 - 13K009 - 80 UNDERHILL AVENUE","d8f57030-30f4-ea11-b882-24ee9a37d45c",-73966333,40678554,"P.S. 9 - BROOKLYN","80 UNDERHILL AVENUE"
3,0,3,"a16b4ae9-ea40-ec11-b8c3-24ee9a37d45c","KIPP Bronx Charter School III - X617 - XCHO - 84X617 - 501 Gerard Avenue","a06b4ae9-ea40-ec11-b8c3-24ee9a37d45c",-73929502,0,"501 Gerard Avenue","501 Gerard Avenue"
4,4,0,"4de61462-31f4-ea11-b882-24ee9a37d45c","Innovation Charter High School - M433 - M099 - 84M433 - 410 EAST 100 STREET","3de61462-31f4-ea11-b882-24ee9a37d45c",-73942154,40785107,"I.S. 99 - MANHATTAN","410 EAST 100 STREET"
4,4,0,"aa28a20c-31f4-ea11-b882-24ee9a37d45c","P.S. 089 Cypress Hills - K089 - K814 - 19K089 - 265 WARWICK STREET","a928a20c-31f4-ea11-b882-24ee9a37d45c",-73886712,40677707,"CYPRESS HILLS COMMUNITY SCHOOL - BROOKLYN","265 WARWICK STREET"
1,1,0,"fd8ac007-ebf6-ea11-b883-24ee9a37d459","KIPP Freedom Charter School - X598 - X859 - 84X598 - 2246 JEROME AVENUE","a3593c87-33f4-ea11-b882-24ee9a37d45c",-73903764,40857932,"P.S. 315 - BRONX","2246 JEROME AVENUE"
1,1,0,"a672c880-32f4-ea11-b882-24ee9a37d45c","Queens Metropolitan High School - Q686 - Q686 - 28Q686 - 91-30 METROPOLITAN AVENUE","a372c880-32f4-ea11-b882-24ee9a37d45c",-73855543,0,"METROPOLITAN AVENUE CAMPUS - QUEENS","91-30 METROPOLITAN AVENUE"
1,1,0,"c8bfa431-33f4-ea11-b882-24ee9a37d45c","KIPP Academy Charter School - X704 - X151 - 84X704 - 250 EAST 156 STREET","c1bfa431-33f4-ea11-b882-24ee9a37d45c",-73921140,40822574,"I.S. 151 - BRONX","250 EAST 156 STREET"
2,1,1,"a169c231-32f4-ea11-b882-24ee9a37d45c","I.S. 204 Oliver W. Holmes - Q204 - Q204 - 30Q204 - 36-41 28 STREET","9c69c231-32f4-ea11-b882-24ee9a37d45c",-73932628,40756471,"I.S. 204 - QUEENS","36-41 28 STREET"
1,1,0,"68e2635c-32f4-ea11-b882-24ee9a37d45c","Academy for Careers in Television and Film - Q301 - Q404 - 30Q301 - 1-50 51ST AVENUE","65e2635c-32f4-ea11-b882-24ee9a37d45c",-73959183,0,"HUNTERS POINT CAMPUS - QUEENS","1-50 51ST AVENUE"
2,2,0,"b7ab074a-33f4-ea11-b882-24ee9a37d45c","P.S./M.S. 194 - X194 - X194 - 11X194 - 2365 WATERBURY AVENUE","b6ab074a-33f4-ea11-b882-24ee9a37d45c",-73846594,40835410,"P.S./I.S. 194 - BRONX","2365 WATERBURY AVENUE"
2,2,0,"159beff9-49fb-ea11-b883-24ee9a37d459","HANSON PLACE CHILD DEVELOPMENT CENTER, INC. - KBMQ - KBMQ -  - 55 HANSON PLACE","169beff9-49fb-ea11-b883-24ee9a37d459",-73975780,40685627,"HANSON PLACE CHILD DEVELOPMENT CENTER, INC.","55 HANSON PLACE"
7,6,1,"5907e99e-31f4-ea11-b882-24ee9a37d45c","High School for Health Professions and Human Services - M420 - M475 - 02M420 - 345 East 15th Street","5607e99e-31f4-ea11-b882-24ee9a37d45c",-73982590,40732665,"HEALTH PROFESSIONS HS (OL STY) - M","345 East 15th Street"
1,0,1,"4bde5eb7-30f4-ea11-b882-24ee9a37d45c","Rachel Carson High School for Coastal Studies - K344 - K303 - 21K344 - 521 WEST AVENUE","4cde5eb7-30f4-ea11-b882-24ee9a37d45c",-73972009,40582518,"I.S. 303 - BROOKLYN","521 WEST AVENUE"
1,1,0,"509f4974-31f4-ea11-b882-24ee9a37d45c","P.S. 146 Ann M. Short - M146 - M146 - 04M146 - 421 EAST 106 STREET","4f9f4974-31f4-ea11-b882-24ee9a37d45c",-73938727,40789535,"P.S. 146 - MANHATTAN","421 EAST 106 STREET"
2,0,2,"3d0410ca-32f4-ea11-b882-24ee9a37d45c","P.S. 56 The Louis Desario School - R056 - R056 - 31R056 - 250 KRAMER AVENUE","3e0410ca-32f4-ea11-b882-24ee9a37d45c",-74213943,40541856,"P.S. 56 - STATEN ISLAND","250 KRAMER AVENUE"
1,1,0,"9eeb0e7b-33f4-ea11-b882-24ee9a37d45c","H.E.R.O. High (Health, Education, and Research Occupations High School) - X259 - X655 - 07X259 - 455 SOUTHERN BLVD","99eb0e7b-33f4-ea11-b882-24ee9a37d45c",-73907528,40810671,"SAMUEL GOMPERS VOC HS - X","455 SOUTHERN BLVD"
2,1,1,"b272c880-32f4-ea11-b882-24ee9a37d45c","Robert F. Kennedy Community High School - Q670 - Q707 - 25Q670 - 75-40 PARSONS BOULEVARD","b372c880-32f4-ea11-b882-24ee9a37d45c",-73811408,40725280,"R. F. KENNEDY COMM. MIDDLE/HS-Q","75-40 PARSONS BOULEVARD"
1,1,0,"9f476368-32f4-ea11-b882-24ee9a37d45c","Flushing High School - Q460 - Q460 - 25Q460 - 35-01 UNION STREET","97476368-32f4-ea11-b882-24ee9a37d45c",-73826811,40764892,"FLUSHING HS - Q","35-01 UNION STREET"
1,0,1,"6f41e65b-31f4-ea11-b882-24ee9a37d45c","P.S. 075 Emily Dickinson - M075 - M075 - 03M075 - 735 WEST END AVENUE","6a41e65b-31f4-ea11-b882-24ee9a37d45c",-73973996,40795109,"P.S. 75 - MANHATTAN","735 WEST END AVENUE"
1,0,1,"ce92e6d5-30f4-ea11-b882-24ee9a37d45c","Cypress Hills Collegiate Preparatory School - K659 - K420 - 19K659 - 999 JAMAICA AVENUE","c692e6d5-30f4-ea11-b882-24ee9a37d45c",-73869305,40693002,"FRANKLIN K. LANE HS - K","999 JAMAICA AVENUE"
3,3,0,"3ce61462-31f4-ea11-b882-24ee9a37d45c","Success Academy Charter School - Harlem 3 - M385 - M099 - 84M385 - 410 EAST 100 STREET","3de61462-31f4-ea11-b882-24ee9a37d45c",-73942154,40785107,"I.S. 99 - MANHATTAN","410 EAST 100 STREET"
1,0,1,"15a31781-33f4-ea11-b882-24ee9a37d45c","P.S. X188 - X188 - X790 - 75X188 - 730 CONCOURSE VILLAGE WEST","0ea31781-33f4-ea11-b882-24ee9a37d45c",-73922366,40821828,"MOTT HAVEN EDUCATIONAL CAMPUS - BRONX","730 CONCOURSE VILLAGE WEST"
2,1,1,"df8442ee-31f4-ea11-b882-24ee9a37d45c","P.S. 038 Rosedale - Q038 - Q038 - 29Q038 - 135-21 241 STREET","e08442ee-31f4-ea11-b882-24ee9a37d45c",-73733774,40671150,"P.S. 38 - QUEENS","135-21 241 STREET"
3,2,1,"88a9d9c3-32f4-ea11-b882-24ee9a37d45c","I.S. 034 Tottenville - R034 - R034 - 31R034 - 528 ACADEMY AVENUE","87a9d9c3-32f4-ea11-b882-24ee9a37d45c",-74243400,0,"I.S. 34 (OLD TOTTENVILLE) - S.I","528 ACADEMY AVENUE"
1,1,0,"ee37fba4-31f4-ea11-b882-24ee9a37d45c","I.S. 528 Bea Fuller Rodgers School - M528 - M528 - 06M528 - 180 WADSWORTH AVENUE","ed37fba4-31f4-ea11-b882-24ee9a37d45c",-73934676,40850683,"I.S. 528 - MANHATTAN","180 WADSWORTH AVENUE"
3,3,0,"a183ff9e-30f4-ea11-b882-24ee9a37d45c","P.S. 253 - K253 - K253 - 21K253 - 601 OCEANVIEW AVENUE","a283ff9e-30f4-ea11-b882-24ee9a37d45c",-73961962,40580237,"P.S. 253 - BROOKLYN","601 OCEANVIEW AVENUE"
1,0,1,"1ae2abc9-30f4-ea11-b882-24ee9a37d45c","P.S. 380 John Wayne Elementary - K380 - K380 - 14K380 - 370 MARCY AVENUE","19e2abc9-30f4-ea11-b882-24ee9a37d45c",-73953702,40701790,"P.S. 380 - BROOKLYN","370 MARCY AVENUE"
1,0,1,"1ea31781-33f4-ea11-b882-24ee9a37d45c","KIPP Academy Charter School - X704 - X790 - 84X704 - 730 CONCOURSE VILLAGE WEST","0ea31781-33f4-ea11-b882-24ee9a37d45c",-73922366,40821828,"MOTT HAVEN EDUCATIONAL CAMPUS - BRONX","730 CONCOURSE VILLAGE WEST"
1,0,1,"59395a2c-ebf6-ea11-b883-24ee9a37d459","P.S. K369 - Coy L. Cox School - K369 - K265 - 75K369 - 101 PARK AVENUE","79b50aa5-30f4-ea11-b882-24ee9a37d45c",-73976104,40697177,"I.S. 265 - BROOKLYN","101 PARK AVENUE"
1,1,0,"68dc32dc-31f4-ea11-b882-24ee9a37d45c","Success Academy Charter School - Hudson Yards - M358 - MBMO - 84M358 - 500 West 41 Street","dd430bd6-31f4-ea11-b882-24ee9a37d45c",-73996499,40758759,"Hudson Yards","500 West 41 Street"
1,1,0,"e4454b50-32f4-ea11-b882-24ee9a37d45c","Learners and Leaders - Q305 - Q320 - 24Q305 - 360 SENECA AVENUE","e5454b50-32f4-ea11-b882-24ee9a37d45c",-73915359,0,"P.S. 320 - QUEENS","360 SENECA AVENUE"
1,1,0,"9c28a20c-31f4-ea11-b882-24ee9a37d45c","Khalil Gibran International Academy - K592 - K806 - 15K592 - 362 SCHERMERHORN STREET","9d28a20c-31f4-ea11-b882-24ee9a37d45c",-73979829,40686147,"METROPOLITAN CORPORATE ACAD. - K","362 SCHERMERHORN STREET"
1,1,0,"4e6e70b7-31f4-ea11-b882-24ee9a37d45c","Community Health Academy of the Heights - M346 - M814 - 06M346 - 504 WEST 158TH STREET","4f6e70b7-31f4-ea11-b882-24ee9a37d45c",-73942074,40833695,"THE COMMUNITY HEALTH ACADEMY OF THE HEIGHTS - M","504 WEST 158TH STREET"
3,2,1,"2bb4977a-32f4-ea11-b882-24ee9a37d45c","Queens High School of Teaching, Liberal Arts and the Sciences - Q566 - Q566 - 26Q566 - 74-20 COMMONWEALTH BLVD","27b4977a-32f4-ea11-b882-24ee9a37d45c",-73728834,0,"QNS HS OF TEACH., LIB. ARTS&SCI-Q","74-20 COMMONWEALTH BLVD"
1,1,0,"88c1797b-ebf6-ea11-b883-24ee9a37d459","Restart Academy - M973 - MAKG - 79M973 - 411 WEST 114 STREET","8a3eb8c9-31f4-ea11-b882-24ee9a37d45c",-73960923,40805305,"CARES","411 WEST 114 STREET"
3,3,0,"bd69c231-32f4-ea11-b882-24ee9a37d45c","P.S. 212 - Q212 - Q212 - 30Q212 - 34-25 82 STREET","b969c231-32f4-ea11-b882-24ee9a37d45c",-73884458,40753035,"P.S. 212 - QUEENS","34-25 82 STREET"
2,0,2,"2806003e-32f4-ea11-b882-24ee9a37d45c","P.S. 239 - Q239 - Q239 - 24Q239 - 17-15 WEIRFIELD STREET","2606003e-32f4-ea11-b882-24ee9a37d45c",-73903838,40699431,"P.S. 239 - QUEENS","17-15 WEIRFIELD STREET"
3,0,3,"84476368-32f4-ea11-b882-24ee9a37d45c","Long Island City High School - Q450 - Q452 - 30Q450 - 14-30 BROADWAY","81476368-32f4-ea11-b882-24ee9a37d45c",-73933907,40765881,"LONG ISLAND CITY HS(NEW)-Q","14-30 BROADWAY"
1,1,0,"31eabc42-30f4-ea11-b882-24ee9a37d45c","Achievement First Brownsville Charter School - K626 - K055 - 84K626 - 2021 BERGEN STREET","32eabc42-30f4-ea11-b882-24ee9a37d45c",-73912685,40674456,"I.S. 55 - BROOKLYN","2021 BERGEN STREET"
1,0,1,"4ab225fb-6c0c-ed11-b091-088e901ef405","P186X Walter J. Damrosch School - X186 - X050 - 75X186 - 1550 VYSE AVENUE","5836d900-33f4-ea11-b882-24ee9a37d45c",-73886995,40834188,"P.S. 50 - BRONX","1550 VYSE AVENUE"
1,0,1,"6c395a2c-ebf6-ea11-b883-24ee9a37d459","P.S. K369 - Coy L. Cox School - K369 - K313 - 75K369 - 283 ADAMS STREET","82e657bd-30f4-ea11-b882-24ee9a37d45c",-73988323,40694629,"ADAMS STREET EDUCATIONAL CAMPUS - K","283 ADAMS STREET"
2,0,2,"f58a0044-33f4-ea11-b882-24ee9a37d45c","The Urban Assembly Bronx Academy of Letters - X551 - X183 - 07X551 - 339 MORRIS AVENUE","ef8a0044-33f4-ea11-b882-24ee9a37d45c",-73925995,0,"J.H.S. 203 - BRONX","339 MORRIS AVENUE"
1,0,1,"64395a2c-ebf6-ea11-b883-24ee9a37d459","Achievement First Apollo Charter School - K774 - K292 - 84K774 - 301 VERMONT STREET","8a283fb1-30f4-ea11-b882-24ee9a37d45c",-73893319,40671601,"I.S. 292 - BROOKLYN","301 VERMONT STREET"
1,0,1,"0878931f-33f4-ea11-b882-24ee9a37d45c","Young Women's Leadership School of the Bronx - X568 - X117 - 09X568 - 1865 MORRIS AVENUE","0578931f-33f4-ea11-b882-24ee9a37d45c",-73909022,40848552,"I.S. 117 - BRONX","1865 MORRIS AVENUE"
2,1,1,"c979df48-30f4-ea11-b882-24ee9a37d45c","Achievement First East New York Charter School - K358 - K065 - 84K358 - 158 RICHMOND STREET","ca79df48-30f4-ea11-b882-24ee9a37d45c",-73877256,40683399,"P.S. 65 - BROOKLYN","158 RICHMOND STREET"
1,1,0,"89464e91-4afb-ea11-b883-24ee9a37d459","KINGSBRIDGE HEIGHTS COMMUNITY CENTER - XAOT - XAOT -  - 3101 KINGSBRIDGE TERRACE","8a464e91-4afb-ea11-b883-24ee9a37d459",-73900687,40877570,"KINGSBRIDGE HEIGHTS COMMUNITY CENTER","3101 KINGSBRIDGE TERRACE"
3,3,0,"076e3d68-31f4-ea11-b882-24ee9a37d45c","Opportunity Charter School - M279 - M113 - 84M279 - 240 WEST 113 STREET","086e3d68-31f4-ea11-b882-24ee9a37d45c",-73955583,0,"P.S. 241 - MANHATTAN","240 WEST 113 STREET"
1,0,1,"df2ece86-32f4-ea11-b882-24ee9a37d45c","Bard High School Early College Queens - Q299 - Q735 - 24Q299 - 30-20 THOMSON AVENUE","db2ece86-32f4-ea11-b882-24ee9a37d45c",-73937004,0,"QUEENS HIGH SCHOOL COMPLEX - Q","30-20 THOMSON AVENUE"
1,0,1,"50fdc1bd-32f4-ea11-b882-24ee9a37d45c","P.S. 013 M. L. Lindemeyer - R013 - R013 - 31R013 - 191 VERMONT AVENUE","51fdc1bd-32f4-ea11-b882-24ee9a37d45c",-74068963,0,"P.S. 13 - STATEN ISLAND","191 VERMONT AVENUE"
2,1,1,"df0d3c5b-30f4-ea11-b882-24ee9a37d45c","P.S. 105 The Blythebourne - K105 - K105 - 20K105 - 1031 59 STREET","e00d3c5b-30f4-ea11-b882-24ee9a37d45c",-74003635,40633320,"P.S. 105 - BROOKLYN","1031 59 STREET"
1,1,0,"011a397a-49fb-ea11-b883-24ee9a37d459","MG SUNSHINE DAYCARE, INC. - REAR - QBKX - QBHA -  - 1109 WYCKOFF AVENUE","021a397a-49fb-ea11-b883-24ee9a37d459",-73901329,40694201,"1109 WYCKOFF AVENUE","1109 WYCKOFF AVENUE"
1,1,0,"5b323483-e21e-eb11-b885-24ee9a37d45c","The Richmond Pre-K Center - R066 - R100 - 31R066 - 2389 Richmond Avenue","5c323483-e21e-eb11-b885-24ee9a37d45c",-74165311,0,"3K CENTER @ 2389 RICHMOND AVENUE - STATEN ISLAND","2389 Richmond Avenue"
1,0,1,"b348b1f5-eaf6-ea11-b883-24ee9a37d459","P.S. M094 - M094 - M276 - 75M094 - 55 BATTERY PLACE","c6e0838c-31f4-ea11-b882-24ee9a37d45c",-74017456,40706384,"P.S./I.S. 276 - MANHATTAN","55 BATTERY PLACE"
1,1,0,"ea77bb9f-33f4-ea11-b882-24ee9a37d45c","Bronx Arena High School - X537 - X972 - 08X537 - 1440 Story Avenue","e877bb9f-33f4-ea11-b882-24ee9a37d45c",-73881187,40820486,"SOUNDVIEW EDUCATIONAL CAMPUS - X","1440 Story Avenue"
7,4,3,"89886843-31f4-ea11-b882-24ee9a37d45c","P.S. 005 Ellen Lurie - M005 - M005 - 06M005 - 3703 TENTH AVENUE","8a886843-31f4-ea11-b882-24ee9a37d45c",-73922277,40857633,"P.S. 5 - MANHATTAN","3703 TENTH AVENUE"
2,0,2,"eef22ce2-31f4-ea11-b882-24ee9a37d45c","P.S. 007 Louis F. Simeone - Q007 - Q007 - 24Q007 - 80-55 CORNISH AVENUE","ecf22ce2-31f4-ea11-b882-24ee9a37d45c",-73882446,40739644,"P.S. 7 - QUEENS","80-55 CORNISH AVENUE"
1,0,1,"03af1f69-ebf6-ea11-b883-24ee9a37d459","P.S. M094 - M094 - M338 - 75M094 - 525 WEST 44TH STREET","dfe0838c-31f4-ea11-b882-24ee9a37d45c",-73995825,40761487,"P.S. 51 ELIAS HOWE - MANHATTAN","525 WEST 44TH STREET"
1,1,0,"429f4974-31f4-ea11-b882-24ee9a37d45c","Washington Heights Expeditionary Learning School - M348 - M143 - 06M348 - 511 WEST 182ND STREET","3f9f4974-31f4-ea11-b882-24ee9a37d45c",-73930991,40849311,"I.S. 143 - MANHATTAN","511 WEST 182ND STREET"
1,0,1,"b028a20c-31f4-ea11-b882-24ee9a37d45c","Aspirations Diploma Plus High School - K646 - K824 - 17K646 - 402 EASTERN PARKWAY","ae28a20c-31f4-ea11-b882-24ee9a37d45c",-73955188,40669561,"W.E.B. DUBOIS HS - BROOKLYN","402 EASTERN PARKWAY"
3,3,0,"f01aad3c-30f4-ea11-b882-24ee9a37d45c","P.S. 031 Samuel F. Dupont - K031 - K031 - 14K031 - 75 MESEROLE AVENUE","f11aad3c-30f4-ea11-b882-24ee9a37d45c",-73954139,40726970,"P.S. 31 (OLD 126) - K","75 MESEROLE AVENUE"
1,0,1,"ffae1f69-ebf6-ea11-b883-24ee9a37d459","P.S. M094 - M094 - M281 - 75M094 - 425 East 35 Street","cde0838c-31f4-ea11-b882-24ee9a37d45c",-73972592,40744288,"P.S. 281 - MANHATTAN","425 East 35 Street"
4,1,3,"18f32ce2-31f4-ea11-b882-24ee9a37d45c","P.S. 019 Marino Jeantet - Q019 - Q019 - 24Q019 - 98-02 ROOSEVELT AVENUE","19f32ce2-31f4-ea11-b882-24ee9a37d45c",-73866557,40748600,"P.S. 19 - QUEENS","98-02 ROOSEVELT AVENUE"
1,1,0,"6fe9a5af-4afb-ea11-b883-24ee9a37d459","Kingsbridge Heights Community Center - XALV - XASJ -  - 295 WEST 231 STREET","70e9a5af-4afb-ea11-b883-24ee9a37d459",-73908163,40880706,"Kingsbridge Innovative Design Charter School","295 WEST 231 STREET"
1,0,1,"86c1797b-ebf6-ea11-b883-24ee9a37d459","P.S. M094 - M094 - M971 - 75M094 - 12 SPRUCE STREET","01ee94c3-31f4-ea11-b882-24ee9a37d45c",-74005473,40711321,"THE SPRUCE STREET EDUCATIONAL CAMPUS","12 SPRUCE STREET"
1,1,0,"8fe657bd-30f4-ea11-b882-24ee9a37d45c","P.S. 503: The School of Discovery - K503 - K314 - 20K503 - 330 59 Street","8ee657bd-30f4-ea11-b882-24ee9a37d45c",-74019299,40641950,"P.S. 314 - BROOKLYN","330 59 Street"
2,0,2,"fcae1f69-ebf6-ea11-b883-24ee9a37d459","P.S. M226 - M226 - M208 - 75M226 - 21 WEST 111 STREET","938d8486-31f4-ea11-b882-24ee9a37d45c",-73950146,40798461,"P.S. 208 (TANDEM M185) - MANHATTAN","21 WEST 111 STREET"
1,0,1,"f43159fa-30f4-ea11-b882-24ee9a37d45c","District 20 Pre-K Center - K768 - K613 - 20K768 - 369 93rd Street","f53159fa-30f4-ea11-b882-24ee9a37d45c",-74031046,0,"PRE-K CENTER @93RD STREET - BROOKLYN","369 93rd Street"
1,0,1,"b748b1f5-eaf6-ea11-b883-24ee9a37d459","P.S. M226 - M226 - M475 - 75M226 - 345 East 15th Street","5607e99e-31f4-ea11-b882-24ee9a37d45c",-73982590,40732665,"HEALTH PROFESSIONS HS (OL STY) - M","345 East 15th Street"
1,0,1,"116e3d68-31f4-ea11-b882-24ee9a37d45c","P.S. 138 - M138 - M114 - 75M138 - 331 EAST 91ST STREET","126e3d68-31f4-ea11-b882-24ee9a37d45c",-73947379,40780452,"EAST SIDE MIDDLE SCHOOL - MANHATTAN","331 EAST 91ST STREET"
1,1,0,"74886843-31f4-ea11-b882-24ee9a37d45c","P.S. Q256 - Q256 - L001 - 75Q256 - 525 CONVENT ROAD","75886843-31f4-ea11-b882-24ee9a37d45c",0,0,"P.S. 256 AX @ ST MARY FAM SERV-Q-S","525 CONVENT ROAD"
3,2,1,"e7f22ce2-31f4-ea11-b882-24ee9a37d45c","I.S. 5 - The Walter Crowley Intermediate School - Q005 - Q005 - 24Q005 - 50-40 JACOBUS STREET","9adc32dc-31f4-ea11-b882-24ee9a37d45c",-73888133,0,"I.S. 5 - QUEENS","50-40 JACOBUS STREET"
5,5,0,"30767649-31f4-ea11-b882-24ee9a37d45c","New Explorations into Science, Technology and Math High School - M539 - M022 - 01M539 - 111 COLUMBIA STREET","31767649-31f4-ea11-b882-24ee9a37d45c",-73979581,40719416,"N.E.S.T (OLD J22) - MANHATTAN","111 COLUMBIA STREET"
1,1,0,"14bc749d-4afb-ea11-b883-24ee9a37d459","THE CITIZEN'S ADVICE BUREAU - XAOD - XAOD -  - 1130 GRAND CONCOURSE","15bc749d-4afb-ea11-b883-24ee9a37d459",-73918761,40832623,"THE CITIZEN'S ADVICE BUREAU","1130 GRAND CONCOURSE"
2,2,0,"f4ae0313-32f4-ea11-b882-24ee9a37d45c","The 30th Avenue School (G&T Citywide) - Q300 - Q126 - 30Q300 - 31-51 21 STREET","f5ae0313-32f4-ea11-b882-24ee9a37d45c",-73929990,0,"I.S. 126 - QUEENS","31-51 21 STREET"
3,3,0,"8f11b2e2-32f4-ea11-b882-24ee9a37d45c","Bridge Preparatory Charter School - R076 - R880 - 84R076 - 715 OCEAN TERRACE","8e11b2e2-32f4-ea11-b882-24ee9a37d45c",-74105883,40607637,"P.S. 80 (PETR COMPL-BLDG B) - S.I.","715 OCEAN TERRACE"
4,4,0,"069c4c1f-32f4-ea11-b882-24ee9a37d45c","P.S. 164 Queens Valley - Q164 - Q164 - 25Q164 - 138-01 77 AVENUE","ff9b4c1f-32f4-ea11-b882-24ee9a37d45c",-73823569,40721514,"P.S. 164 - QUEENS","138-01 77 AVENUE"
2,2,0,"5b8946f4-31f4-ea11-b882-24ee9a37d45c","P.S. 045 Clarence Witherspoon - Q045 - Q045 - 27Q045 - 126-28 150 STREET","5c8946f4-31f4-ea11-b882-24ee9a37d45c",-73788866,0,"P.S. 45 - QUEENS","126-28 150 STREET"
2,1,1,"062ed53d-33f4-ea11-b882-24ee9a37d45c","Hostos-Lincoln Academy of Science - X500 - X162 - 07X500 - 600 SAINT ANN'S AVENUE","032ed53d-33f4-ea11-b882-24ee9a37d45c",-73912038,40814857,"I.S. 162 - BRONX","600 SAINT ANN'S AVENUE"
1,1,0,"eeb98b86-30f4-ea11-b882-24ee9a37d45c","P.S. 195 Manhattan Beach - K195 - K195 - 22K195 - 131 IRWIN STREET","efb98b86-30f4-ea11-b882-24ee9a37d45c",-73943498,40580161,"P.S. 195 - BROOKLYN","131 IRWIN STREET"
3,2,1,"84a9d9c3-32f4-ea11-b882-24ee9a37d45c","P.S. 032 The Gifford School - R032 - R032 - 31R032 - 232 Barlow Avenue","80a9d9c3-32f4-ea11-b882-24ee9a37d45c",-74155400,0,"P.S. 32 - STATEN ISLAND","232 Barlow Avenue"
1,0,1,"e09319d7-ebf6-ea11-b883-24ee9a37d459","The Richmond Pre-K Center - R066 - R093 - 31R066 - 2530 VICTORY BOULEVARD","f58521d0-32f4-ea11-b882-24ee9a37d45c",-74147690,0,"3K CENTER @ 2530 VICTORY BOULEVARD - STATEN ISLAND","2530 VICTORY BOULEVARD"
3,3,0,"f98a0044-33f4-ea11-b882-24ee9a37d45c","South Bronx Academy for Applied Media - X296 - X184 - 07X296 - 778 FOREST AVENUE","f88a0044-33f4-ea11-b882-24ee9a37d45c",-73905389,40818703,"I.S. 184 - BRONX","778 FOREST AVENUE"
1,0,1,"59323483-e21e-eb11-b885-24ee9a37d45c","The Richmond Pre-K Center - R066 - R101 - 31R066 - 1275 Woodrow Road","5a323483-e21e-eb11-b885-24ee9a37d45c",-74207489,0,"3K CENTER @ 1275 WOODROW ROAD - STATEN ISLAND","1275 Woodrow Road"
3,0,3,"270b210d-33f4-ea11-b882-24ee9a37d45c","P.S. 195 - X195 - X077 - 12X195 - 1250 WARD AVENUE","230b210d-33f4-ea11-b882-24ee9a37d45c",-73877305,40830811,"P.S. 195 - BRONX","1250 WARD AVENUE"
1,1,0,"1c005d7a-31f4-ea11-b882-24ee9a37d45c","Yorkville East Middle School - M177 - M158 - 02M177 - 1458 YORK AVENUE","1d005d7a-31f4-ea11-b882-24ee9a37d45c",-73950745,40770215,"P.S. 158 - MANHATTAN","1458 YORK AVENUE"
1,1,0,"310410ca-32f4-ea11-b882-24ee9a37d45c","P.S. 052 John C. Thompson - R052 - R052 - 31R052 - 450 BUEL AVENUE","320410ca-32f4-ea11-b882-24ee9a37d45c",-74089012,0,"P.S. 52 - STATEN ISLAND","450 BUEL AVENUE"
2,1,1,"d3201dab-30f4-ea11-b882-24ee9a37d45c","P.S. 274 Kosciusko - K274 - K274 - 32K274 - 800 BUSHWICK AVENUE","d4201dab-30f4-ea11-b882-24ee9a37d45c",-73928180,40694179,"P.S. 274 - BROOKLYN","800 BUSHWICK AVENUE"
1,0,1,"ffb98b86-30f4-ea11-b882-24ee9a37d45c","P.S. 200 Benson School - K200 - K200 - 20K200 - 1940 BENSON AVENUE","00ba8b86-30f4-ea11-b882-24ee9a37d45c",-74001915,40602809,"P.S. 200 - BROOKLYN","1940 BENSON AVENUE"
1,0,1,"748946f4-31f4-ea11-b882-24ee9a37d45c","Success Academy Charter School - Far Rockaway - Q375 - Q053 - 84Q375 - 10-45 NAMEOKE STREET","648946f4-31f4-ea11-b882-24ee9a37d45c",-73749891,40604019,"I.S. 53 - QUEENS","10-45 NAMEOKE STREET"
2,2,0,"48507380-31f4-ea11-b882-24ee9a37d45c","Amistad Dual Language School - M311 - M176 - 06M311 - 4862 BROADWAY","46507380-31f4-ea11-b882-24ee9a37d45c",-73923818,40866381,"P.S./I.S. 176 - MANHATTAN","4862 BROADWAY"
2,1,1,"18a6ba98-31f4-ea11-b882-24ee9a37d45c","Success Academy Charter School - Union Square - M174 - M460 - 84M174 - 40 IRVING PLACE","16a6ba98-31f4-ea11-b882-24ee9a37d45c",-73987064,40735361,"WASHINGTON IRVING HS - MANHATTAN","40 IRVING PLACE"
1,1,0,"e7ba3c50-33f4-ea11-b882-24ee9a37d45c","P.S. 204 Morris Heights - X204 - X338 - 09X204 - 1780 Dr. Martin Luther King Jr. Blvd","e3ba3c50-33f4-ea11-b882-24ee9a37d45c",-73915217,40849416,"MORRIS HEIGHTS EDUCATIONAL COMPLEX - BRONX","1780 Dr. Martin Luther King Jr. Blvd"
1,1,0,"ea201dab-30f4-ea11-b882-24ee9a37d45c","P.S. 279 Herman Schreiber - K279 - K279 - 18K279 - 1070 EAST 104 STREET","e3201dab-30f4-ea11-b882-24ee9a37d45c",-73892797,40644134,"P.S. 279 - BROOKLYN","1070 EAST 104 STREET"
2,2,0,"3b0d6d19-33f4-ea11-b882-24ee9a37d45c","P.S. 106 Parkchester - X106 - X106 - 11X106 - 1514 OLMSTEAD AVENUE","3c0d6d19-33f4-ea11-b882-24ee9a37d45c",-73854823,40836974,"P.S. 106 - BRONX","1514 OLMSTEAD AVENUE"
2,0,2,"6636d900-33f4-ea11-b882-24ee9a37d45c","P.S./I.S. 54 - X054 - X054 - 10X054 - 2703 WEBSTER AVENUE","6736d900-33f4-ea11-b882-24ee9a37d45c",-73887940,40864872,"P.S. 54 - BRONX","2703 WEBSTER AVENUE"
2,0,2,"8e69c231-32f4-ea11-b882-24ee9a37d45c","P.S. 199 Maurice A. Fitzgerald - Q199 - Q199 - 24Q199 - 39-20 48 Avenue","98977d2b-32f4-ea11-b882-24ee9a37d45c",-73926081,40739831,"P.S. 199 - QUEENS","39-20 48 Avenue"
1,1,0,"0ac0fb05-4afb-ea11-b883-24ee9a37d459","Nuestros Ninos CDS III - KBVD - KBVD -  - 161 South 3rd Street","0bc0fb05-4afb-ea11-b883-24ee9a37d459",-73961162,40712253,"Nuestros Ninos CDS III","161 South 3rd Street"
1,0,1,"1630f69f-ebf6-ea11-b883-24ee9a37d459","P.S. 009 - Q009 - Q209 - 75Q009 - 16-10 Utopia Parkway","b569c231-32f4-ea11-b882-24ee9a37d45c",-73795845,40783777,"P.S. 209 - QUEENS","16-10 Utopia Parkway"
3,2,1,"b9edf392-32f4-ea11-b882-24ee9a37d45c","P.S. 099 Kew Gardens - Q099 - Q866 - 28Q099 - 83-34 Kew Gardens Road","baedf392-32f4-ea11-b882-24ee9a37d45c",-73827276,40709492,"P.S. 99 ANNEX - QUEENS","83-34 Kew Gardens Road"
2,0,2,"fe77931f-33f4-ea11-b882-24ee9a37d45c","School of Performing Arts - X217 - X116 - 12X217 - 977 FOX STREET","fd77931f-33f4-ea11-b882-24ee9a37d45c",-73894368,40822056,"I.S. 216 - BRONX","977 FOX STREET"
1,1,0,"86eb6056-32f4-ea11-b882-24ee9a37d45c","The CIVIC School of Bayside Hills - Q390 - Q361 - 26Q390 - 56-10 214 Street","85eb6056-32f4-ea11-b882-24ee9a37d45c",-73764954,0,"P.S. @ 56-10 214 STREET - QUEENS","56-10 214 Street"
1,0,1,"2d7c21b7-32f4-ea11-b882-24ee9a37d45c","P.S. 001 Tottenville - R001 - R001 - 31R001 - 58 SUMMIT STREET","2e7c21b7-32f4-ea11-b882-24ee9a37d45c",-74243950,40508638,"P.S. 1 - STATEN ISLAND","58 SUMMIT STREET"
2,1,1,"55fdc1bd-32f4-ea11-b882-24ee9a37d45c","P.S. 016 John J. Driscoll - R016 - R016 - 31R016 - 195 DANIEL LOW TERRACE","56fdc1bd-32f4-ea11-b882-24ee9a37d45c",-74079594,0,"P.S. 16 - STATEN ISLAND","195 DANIEL LOW TERRACE"
1,0,1,"e72ece86-32f4-ea11-b882-24ee9a37d45c","Civic Leadership Academy - Q293 - Q744 - 24Q293 - 45-10 94th Street","e22ece86-32f4-ea11-b882-24ee9a37d45c",-73871505,40743228,"ELMHURST EDUCATIONAL CAMPUS - Q","45-10 94th Street"
2,0,2,"c08442ee-31f4-ea11-b882-24ee9a37d45c","P.S. 029 Queens - Q029 - Q029 - 25Q029 - 125-10 23 AVENUE","c18442ee-31f4-ea11-b882-24ee9a37d45c",-73842967,40778029,"P.S. 29 - QUEENS","125-10 23 AVENUE"
2,1,1,"2baf0313-32f4-ea11-b882-24ee9a37d45c","P.S. 139 Rego Park - Q139 - Q139 - 28Q139 - 93-06 63 DRIVE","29af0313-32f4-ea11-b882-24ee9a37d45c",-73862561,40728012,"P.S. 139 - QUEENS","93-06 63 DRIVE"
1,1,0,"8c0e6e25-32f4-ea11-b882-24ee9a37d45c","Irwin Altman Middle School 172 - Q172 - Q172 - 26Q172 - 81-14 257 Street","8d0e6e25-32f4-ea11-b882-24ee9a37d45c",-73713245,40741409,"J.H.S. 172 - QUEENS","81-14 257 Street"
2,2,0,"fbf22ce2-31f4-ea11-b882-24ee9a37d45c","I.S. 010 Horace Greeley - Q010 - Q010 - 30Q010 - 45-11 31st Ave","fcf22ce2-31f4-ea11-b882-24ee9a37d45c",-73911962,0,"I.S. 10 - QUEENS","45-11 31st Ave"
1,0,1,"7c977d2b-32f4-ea11-b882-24ee9a37d45c","P.S. 191 Mayflower - Q191 - Q191 - 26Q191 - 85-15 258 STREET","7b977d2b-32f4-ea11-b882-24ee9a37d45c",-73708617,40734266,"P.S. 191 - QUEENS","85-15 258 STREET"
1,1,0,"efce496e-31f4-ea11-b882-24ee9a37d45c","P.S. 125 Ralph Bunche - M125 - M125 - 05M125 - 425 WEST 123 STREET","edce496e-31f4-ea11-b882-24ee9a37d45c",-73955722,40810793,"P.S. 125 - MANHATTAN","425 WEST 123 STREET"
3,3,0,"502f7d06-31f4-ea11-b882-24ee9a37d45c","The Maurice Sendak Community School - K118 - K763 - 15K118 - 211 8TH STREET","512f7d06-31f4-ea11-b882-24ee9a37d45c",-73987602,40671145,"P.S. 118 MAURICE SENDAK COMMUNITY SCHOOL- BROOKLYN","211 8TH STREET"
1,0,1,"fb8ac007-ebf6-ea11-b883-24ee9a37d459","P.S. X721 - Stephen McSweeney School - X721 - X722 - 75X721 - 2697 WESTCHESTER AVENUE","06a31781-33f4-ea11-b882-24ee9a37d45c",-73839114,40842725,"P.S. 721 (OTC) - BRONX","2697 WESTCHESTER AVENUE"
2,2,0,"790e6e25-32f4-ea11-b882-24ee9a37d45c","P.S. 166 Henry Gradstein - Q166 - Q166 - 30Q166 - 33-09 35 AVENUE","7a0e6e25-32f4-ea11-b882-24ee9a37d45c",-73926249,40757497,"P.S. 166 - QUEENS","33-09 35 AVENUE"
1,1,0,"377c21b7-32f4-ea11-b882-24ee9a37d45c","P.S. 004 Maurice Wollin - R004 - R004 - 31R004 - 200 NEDRA LANE","337c21b7-32f4-ea11-b882-24ee9a37d45c",-74195281,0,"P.S. 4 - STATEN ISLAND","200 NEDRA LANE"
2,1,1,"3e2f7d06-31f4-ea11-b882-24ee9a37d45c","P.S. 207 Elizabeth G. Leary - K207 - K729 - 22K207 - 3874 Flatlands Avenue","3f2f7d06-31f4-ea11-b882-24ee9a37d45c",-73935842,40619891,"P.S. 207 ANNEX - BROOKLYN","3874 Flatlands Avenue"
2,2,0,"c579df48-30f4-ea11-b882-24ee9a37d45c","J.H.S. 062 Ditmas - K062 - K062 - 20K062 - 700 Cortelyou Road","c479df48-30f4-ea11-b882-24ee9a37d45c",-73971153,0,"I.S. 62 - BROOKLYN","700 Cortelyou Road"
1,0,1,"728946f4-31f4-ea11-b882-24ee9a37d45c","M.S. 053 Brian Piccolo - Q053 - Q053 - 27Q053 - 10-45 NAMEOKE STREET","648946f4-31f4-ea11-b882-24ee9a37d45c",-73749891,40604019,"I.S. 53 - QUEENS","10-45 NAMEOKE STREET"
1,1,0,"898946f4-31f4-ea11-b882-24ee9a37d45c","I.S. 059 Springfield Gardens - Q059 - Q059 - 29Q059 - 132-55 RIDGEDALE STREET","878946f4-31f4-ea11-b882-24ee9a37d45c",-73752772,40681881,"I.S. 59 - QUEENS","132-55 RIDGEDALE STREET"
1,1,0,"49ebaa73-30f4-ea11-b882-24ee9a37d45c","The East New York Arts and Civics High School - K953 - K166 - 19K953 - 800 VAN SICLEN AVE","41ebaa73-30f4-ea11-b882-24ee9a37d45c",-73885704,40659934,"I.S. 166 - BROOKLYN","800 VAN SICLEN AVE"
2,2,0,"ba689025-33f4-ea11-b882-24ee9a37d45c","J.H.S. 127 The Castle Hill - X127 - X127 - 11X127 - 1560 PURDY STREET","b9689025-33f4-ea11-b882-24ee9a37d45c",-73853203,40838759,"I.S. 127 - BRONX","1560 PURDY STREET"
1,1,0,"68977d2b-32f4-ea11-b882-24ee9a37d45c","P.S. 186 Castlewood - Q186 - Q186 - 26Q186 - 252-12 72 AVENUE","67977d2b-32f4-ea11-b882-24ee9a37d45c",-73721594,40749556,"P.S. 186 - QUEENS","252-12 72 AVENUE"
1,0,1,"1e9ebaee-32f4-ea11-b882-24ee9a37d45c","P.S. 9 Ryer Avenue Elementary School - X009 - X009 - 10X009 - 230 EAST 183 STREET","169ebaee-32f4-ea11-b882-24ee9a37d45c",-73898821,40856440,"P.S. 9 (OLD 115) - BRONX","230 EAST 183 STREET"
1,1,0,"8f977d2b-32f4-ea11-b882-24ee9a37d45c","P.S. 196 Grand Central Parkway - Q196 - Q196 - 28Q196 - 71-25 113 STREET","90977d2b-32f4-ea11-b882-24ee9a37d45c",-73837379,40722792,"P.S. 196 - QUEENS","71-25 113 STREET"
1,1,0,"3245378b-4afb-ea11-b883-24ee9a37d459","Trabajamos Community Head Start, Inc. Center # 6 - XAHH - XAKP -  - 1997 BATHGATE AVENUE","3345378b-4afb-ea11-b883-24ee9a37d459",-73896075,40848824,"BATHGATE LEARNING CENTER","1997 BATHGATE AVENUE"
1,1,0,"b479df48-30f4-ea11-b882-24ee9a37d45c","Success Academy Charter School - Bed Stuy 2 - K125 - K059 - 84K125 - 211 THROOP AVENUE","b579df48-30f4-ea11-b882-24ee9a37d45c",-73943279,40697619,"P.S. 59 - BROOKLYN","211 THROOP AVENUE"
2,0,2,"19fc3df4-30f4-ea11-b882-24ee9a37d45c","P.S. 371 - Lillian L. Rashkis - K371 - K564 - 75K371 - 153 35 Street","18fc3df4-30f4-ea11-b882-24ee9a37d45c",-74004342,40655583,"SUNSET PARK HS - BROOKLYN","153 35 Street"
1,0,1,"3370f999-ebf6-ea11-b883-24ee9a37d459","The Riverview School - Q277 - Q204 - 75Q277 - 36-41 28 STREET","9c69c231-32f4-ea11-b882-24ee9a37d45c",-73932628,40756471,"I.S. 204 - QUEENS","36-41 28 STREET"
1,0,1,"077eed06-32f4-ea11-b882-24ee9a37d45c","P.S. 082 Hammond - Q082 - Q082 - 28Q082 - 88-02 144 STREET","e3e8ce00-32f4-ea11-b882-24ee9a37d45c",-73812200,40703897,"P.S. 82 - QUEENS","88-02 144 STREET"
1,1,0,"555bc58c-30f4-ea11-b882-24ee9a37d45c","P.S. 216 Arturo Toscanini - K216 - K216 - 21K216 - 350 AVENUE X","565bc58c-30f4-ea11-b882-24ee9a37d45c",-73969647,40590000,"P.S. 216 - BROOKLYN","350 AVENUE X"
1,1,0,"c0fc24e8-31f4-ea11-b882-24ee9a37d45c","I.S. 025 Adrien Block - Q025 - Q025 - 25Q025 - 34-65 192 STREET","befc24e8-31f4-ea11-b882-24ee9a37d45c",-73789365,0,"J.H.S. 25 - QUEENS","34-65 192 STREET"
1,0,1,"0bbef08c-32f4-ea11-b882-24ee9a37d45c","P.S. 082 Hammond - Q082 - Q814 - 28Q082 - 108-43 SUTPHIN BOULEVARD","0cbef08c-32f4-ea11-b882-24ee9a37d45c",-73798144,40692548,"P.S. 82 ANNEX - QUEENS","108-43 SUTPHIN BOULEVARD"
1,0,1,"5536d900-33f4-ea11-b882-24ee9a37d45c","P.S. 049 Willis Avenue - X049 - X049 - 07X049 - 383 EAST 139 STREET","4d36d900-33f4-ea11-b882-24ee9a37d45c",-73922730,40810413,"P.S. 49 - BRONX","383 EAST 139 STREET"
3,1,2,"f0d27c6d-30f4-ea11-b882-24ee9a37d45c","School of Science & Technology - K152 - K152 - 22K152 - 725 EAST 23 STREET","efd27c6d-30f4-ea11-b882-24ee9a37d45c",-73954269,40632619,"P.S. 152 - BROOKLYN","725 EAST 23 STREET"
1,1,0,"5a9f4974-31f4-ea11-b882-24ee9a37d45c","P.S. 152 Dyckman Valley - M152 - M152 - 06M152 - 93 NAGLE AVENUE","5b9f4974-31f4-ea11-b882-24ee9a37d45c",-73927578,40859804,"P.S. 152 - MANHATTAN","93 NAGLE AVENUE"
2,1,1,"320b210d-33f4-ea11-b882-24ee9a37d45c","School for Environmental Citizenship - X386 - X079 - 10X386 - 125 EAST 181 STREET","2c0b210d-33f4-ea11-b882-24ee9a37d45c",-73903139,0,"P.S. 79 - BRONX","125 EAST 181 STREET"
2,1,1,"e62d6c32-ebf6-ea11-b883-24ee9a37d459","P.S. K771 - K771 - K329 - 75K771 - 2929 WEST 30 STREET","11a198c3-30f4-ea11-b882-24ee9a37d45c",-73995770,40574666,"P.S. 329 - BROOKLYN","2929 WEST 30 STREET"
1,1,0,"e6b98b86-30f4-ea11-b882-24ee9a37d45c","P.S. 193 Gil Hodges - K193 - K193 - 22K193 - 2515 AVENUE L","e5b98b86-30f4-ea11-b882-24ee9a37d45c",-73950321,40622080,"P.S. 193 - BROOKLYN","2515 AVENUE L"
2,2,0,"9d69c231-32f4-ea11-b882-24ee9a37d45c","P.S. 203 Oakland Gardens - Q203 - Q203 - 26Q203 - 53-11 SPRINGFIELD BOULEVARD","9e69c231-32f4-ea11-b882-24ee9a37d45c",-73759822,40753606,"P.S. 203 - QUEENS","53-11 SPRINGFIELD BOULEVARD"
1,1,0,"4b6e70b7-31f4-ea11-b882-24ee9a37d45c","High School for Mathematics, Science and Engineering at City College - M692 - M812 - 05M692 - 240 CONVENT AVE","4c6e70b7-31f4-ea11-b882-24ee9a37d45c",-73950354,0,"HS FOR MATH, SCI & ENGINEERING-M","240 CONVENT AVE"
1,1,0,"635b4cd6-32f4-ea11-b882-24ee9a37d45c","Tottenville High School - R455 - R455 - 31R455 - 100 LUTEN AVENUE","605b4cd6-32f4-ea11-b882-24ee9a37d45c",-74193431,40528152,"TOTTENVILLE HS - S. I.","100 LUTEN AVENUE"
2,1,1,"af2aa42b-33f4-ea11-b882-24ee9a37d45c","The Marie Curie School for Medicine, Nursing, and Health Professions - X237 - X143 - 10X237 - 120 WEST 231 STREET","ad2aa42b-33f4-ea11-b882-24ee9a37d45c",-73901565,40875636,"I.S. 143 - BRONX","120 WEST 231 STREET"
13,11,2,"435b4cd6-32f4-ea11-b882-24ee9a37d45c","New Dorp High School - R440 - R435 - 31R440 - 465 NEW DORP LANE","fb8521d0-32f4-ea11-b882-24ee9a37d45c",-74105878,40570909,"NEW DORP HS (NEW) - S. I.","465 NEW DORP LANE"
1,1,0,"ceb36d80-30f4-ea11-b882-24ee9a37d45c","P.S. 185 Walter Kassenbrock - K185 - K185 - 20K185 - 8601 RIDGE BOULEVARD","cfb36d80-30f4-ea11-b882-24ee9a37d45c",-74033429,40623598,"P.S. 185 - BROOKLYN","8601 RIDGE BOULEVARD"
1,1,0,"66395a2c-ebf6-ea11-b883-24ee9a37d459","P.S. K053 - K053 - K296 - 75K053 - 125 COVERT STREET","99283fb1-30f4-ea11-b882-24ee9a37d45c",-73910589,40688647,"I.S. 296 - BROOKLYN","125 COVERT STREET"
2,0,2,"659d7c62-33f4-ea11-b882-24ee9a37d45c","Mott Hall V - X242 - X423 - 12X242 - 1551 EAST 172ND STREET","639d7c62-33f4-ea11-b882-24ee9a37d45c",-73878191,40832508,"JAMES MONROE HS CAMPUS ANNEX - BRONX","1551 EAST 172ND STREET"
2,0,2,"16a198c3-30f4-ea11-b882-24ee9a37d45c","P.S./I.S. 30 Mary White Ovington - K030 - K331 - 20K030 - 7002 4TH AVENUE","15a198c3-30f4-ea11-b882-24ee9a37d45c",-74023950,40633598,"P.S./I.S.30 MARY WHITE OVINGTON - BROOKLYN","7002 4TH AVENUE"
2,1,1,"d8201dab-30f4-ea11-b882-24ee9a37d45c","Brooklyn Democracy Academy - K643 - K275 - 23K643 - 985 ROCKAWAY AVENUE","d2201dab-30f4-ea11-b882-24ee9a37d45c",-73906662,40655644,"I.S. 275 - BROOKLYN","985 ROCKAWAY AVENUE"
1,1,0,"db21d292-30f4-ea11-b882-24ee9a37d45c","P.S. 222 Katherine R. Snyder - K222 - K222 - 22K222 - 3301 QUENTIN ROAD","dc21d292-30f4-ea11-b882-24ee9a37d45c",-73939205,40614005,"P.S. 222 - BROOKLYN","3301 QUENTIN ROAD"
4,1,3,"d22ff20c-32f4-ea11-b882-24ee9a37d45c","P.S. 117 J. Keld / Briarwood School - Q117 - Q117 - 28Q117 - 85-15 143 STREET","d32ff20c-32f4-ea11-b882-24ee9a37d45c",-73812968,40710428,"P.S. 117 - QUEENS","85-15 143 STREET"
1,1,0,"818946f4-31f4-ea11-b882-24ee9a37d45c","P.S. 056 Harry Eichler - Q056 - Q056 - 27Q056 - 86-10 114 STREET","828946f4-31f4-ea11-b882-24ee9a37d45c",-73835735,40698989,"P.S. 56 (OLD R HILL AX) - QUEENS","86-10 114 STREET"
2,2,0,"2c06003e-32f4-ea11-b882-24ee9a37d45c","P.S. 242 Leonard P. Stavisky Early Childhood School - Q242 - Q242 - 25Q242 - 29-66 137 STREET","2d06003e-32f4-ea11-b882-24ee9a37d45c",-73832005,40769752,"P.S. 242 - (ECC) - QUEENS","29-66 137 STREET"
1,1,0,"f9b6c337-32f4-ea11-b882-24ee9a37d45c","P.S. 213 The Carl Ullman School - Q213 - Q213 - 26Q213 - 231-02 67 AVENUE","f8b6c337-32f4-ea11-b882-24ee9a37d45c",-73745390,40747457,"P.S. 213 - QUEENS","231-02 67 AVENUE"
2,2,0,"920e6e25-32f4-ea11-b882-24ee9a37d45c","P.S. 174 William Sidney Mount - Q174 - Q174 - 28Q174 - 65-10 DIETERLE CRESCENT","930e6e25-32f4-ea11-b882-24ee9a37d45c",-73861462,40720583,"P.S. 174 - QUEENS","65-10 DIETERLE CRESCENT"
1,1,0,"5588e6db-30f4-ea11-b882-24ee9a37d45c","New Utrecht High School - K445 - K445 - 20K445 - 1601 80 STREET","5488e6db-30f4-ea11-b882-24ee9a37d45c",-74002308,40613041,"NEW UTRECHT HS - K","1601 80 STREET"
2,2,0,"d78a0044-33f4-ea11-b882-24ee9a37d45c","Archimedes Academy for Math, Science and Technology Applications - X367 - X174 - 08X367 - 456 WHITE PLAINS ROAD","2a2ed53d-33f4-ea11-b882-24ee9a37d45c",-73856070,40815043,"I.S. 174 - BRONX","456 WHITE PLAINS ROAD"
1,1,0,"91e657bd-30f4-ea11-b882-24ee9a37d45c","P.S. 506: The School of Journalism & Technology - K506 - K314 - 20K506 - 330 59 Street","8ee657bd-30f4-ea11-b882-24ee9a37d45c",-74019299,40641950,"P.S. 314 - BROOKLYN","330 59 Street"
2,0,2,"3d3cbf01-ebf6-ea11-b883-24ee9a37d459","John F. Kennedy Jr. School - Q721 - Q722 - 75Q721 - 57-12 94 STREET","b172c880-32f4-ea11-b882-24ee9a37d45c",-73867882,40735613,"JOHN F. KENNEDY JR. SCHOOL - QUEENS","57-12 94 STREET"
1,0,1,"12c73b4a-32f4-ea11-b882-24ee9a37d45c","David N. Dinkins School - Q048 - Q276 - 28Q048 - 108-29 155 STREET","0ec73b4a-32f4-ea11-b882-24ee9a37d45c",-73796358,40693736,"THE WILLIAM WORDSWORTH EDUCATIONAL COMPLEX","108-29 155 STREET"
1,1,0,"6507e99e-31f4-ea11-b882-24ee9a37d45c","Manhattan International High School - M459 - M480 - 02M459 - 317 EAST 67 STREET","6007e99e-31f4-ea11-b882-24ee9a37d45c",-73959777,40765638,"JULIA RICHMAN ED. COMPLEX - M","317 EAST 67 STREET"
2,1,1,"9f53dd74-33f4-ea11-b882-24ee9a37d45c","Marble Hill High School for International Studies - X477 - X475 - 10X477 - 99 TERRACE VIEW AVENUE","9853dd74-33f4-ea11-b882-24ee9a37d45c",-73912686,40877379,"JOHN F. KENNEDY HS - X","99 TERRACE VIEW AVENUE"
1,1,0,"d9e0a4fb-ebf6-ea11-b883-24ee9a37d459","P.S. 723 - X723 - X189 - 75X723 - 3441 STEENWICK AVENUE","018b0044-33f4-ea11-b882-24ee9a37d45c",-73830616,40882778,"P.S./I.S. 189 - BRONX","3441 STEENWICK AVENUE"
1,1,0,"1f005d7a-31f4-ea11-b882-24ee9a37d45c","P.S. 158 Bayard Taylor - M158 - M158 - 02M158 - 1458 YORK AVENUE","1d005d7a-31f4-ea11-b882-24ee9a37d45c",-73950745,40770215,"P.S. 158 - MANHATTAN","1458 YORK AVENUE"
1,0,1,"54de5eb7-30f4-ea11-b882-24ee9a37d45c","Brighter Choice Community School - K627 - K304 - 16K627 - 280 HART STREET","53de5eb7-30f4-ea11-b882-24ee9a37d45c",-73941278,40693654,"P.S. 304 - BROOKLYN","280 HART STREET"
4,3,1,"60b50aa5-30f4-ea11-b882-24ee9a37d45c","J.H.S. 259 William McKinley - K259 - K259 - 20K259 - 7305 Ft Hamilton Parkway","61b50aa5-30f4-ea11-b882-24ee9a37d45c",-74014633,40626089,"I.S. 259 - BROOKLYN","7305 Ft Hamilton Parkway"
1,1,0,"d03159fa-30f4-ea11-b882-24ee9a37d45c","Sunset Park High School - K667 - K564 - 15K667 - 153 35 Street","18fc3df4-30f4-ea11-b882-24ee9a37d45c",-74004342,40655583,"SUNSET PARK HS - BROOKLYN","153 35 Street"
1,1,0,"209ebaee-32f4-ea11-b882-24ee9a37d45c","P.S. X015 Institute for Environmental Learning - X015 - X015 - 10X015 - 2195 ANDREWS AVENUE","219ebaee-32f4-ea11-b882-24ee9a37d45c",-73909763,40859243,"P.S. 15 - BRONX","2195 ANDREWS AVENUE"
1,0,1,"7ef4a0ef-eaf6-ea11-b883-24ee9a37d459","P.S. K721 - Brooklyn Occupational Training Center - K721 - K722 - 75K721 - 64 AVENUE X","392f7d06-31f4-ea11-b882-24ee9a37d45c",-73981925,40588070,"P.S. 721 OTC - BROOKLYN","64 AVENUE X"
2,0,2,"d211f898-32f4-ea11-b882-24ee9a37d45c","P.S. 65 - The Raymond York Elementary School - Q065 - Q884 - 27Q065 - 103-22 99 STREET","d111f898-32f4-ea11-b882-24ee9a37d45c",-73841675,40682293,"P.S. 65 - QUEENS","103-22 99 STREET"
3,1,2,"a483ff9e-30f4-ea11-b882-24ee9a37d45c","P.S. 254 Dag Hammarskjold - K254 - K254 - 22K254 - 2469 East 18 Street","a583ff9e-30f4-ea11-b882-24ee9a37d45c",-73951550,40591103,"P.S. 254 - BROOKLYN","2469 East 18 Street"
1,1,0,"f3f22ce2-31f4-ea11-b882-24ee9a37d45c","J.H.S. 008 Richard S. Grossley - Q008 - Q008 - 28Q008 - 108-35 167 STREET","f1f22ce2-31f4-ea11-b882-24ee9a37d45c",-73786403,0,"J.H.S. 8 - QUEENS","108-35 167 STREET"
1,1,0,"d3d27c6d-30f4-ea11-b882-24ee9a37d45c","Young Women's Leadership School of Brooklyn - K614 - K147 - 14K614 - 325 BUSHWICK AVENUE","d4d27c6d-30f4-ea11-b882-24ee9a37d45c",-73938790,40705005,"P.S. 147 - BROOKLYN","325 BUSHWICK AVENUE"
2,1,1,"186e3d68-31f4-ea11-b882-24ee9a37d45c","P.S. 115 Alexander Humboldt - M115 - M115 - 06M115 - 586 WEST 177 STREET","166e3d68-31f4-ea11-b882-24ee9a37d45c",-73935140,40846116,"P.S. 115 - MANHATTAN","586 WEST 177 STREET"
1,1,0,"f1454b50-32f4-ea11-b882-24ee9a37d45c","East Elmhurst Community School - Q329 - Q329 - 30Q329 - 26-25 97th Street","f0454b50-32f4-ea11-b882-24ee9a37d45c",-73872244,0,"EAST ELMHURST COMMUNITY SCHOOL - QUEENS","26-25 97th Street"
1,0,1,"72d92255-30f4-ea11-b882-24ee9a37d45c","P.S. 086 The Irvington - K086 - K086 - 32K086 - 220 IRVING AVENUE","71d92255-30f4-ea11-b882-24ee9a37d45c",-73917804,40700595,"P.S. 86 - BROOKLYN","220 IRVING AVENUE"
2,2,0,"47fdc1bd-32f4-ea11-b882-24ee9a37d45c","P.S. 8 Shirlee Solomon - R008 - R008 - 31R008 - 112 LINDENWOOD ROAD","48fdc1bd-32f4-ea11-b882-24ee9a37d45c",-74152212,0,"P.S. 8 - STATEN ISLAND","112 LINDENWOOD ROAD"
5,0,5,"38c73b4a-32f4-ea11-b882-24ee9a37d45c","Corona Arts & Sciences Academy - Q311 - Q311 - 24Q311 - 98-11 44TH AVENUE","36c73b4a-32f4-ea11-b882-24ee9a37d45c",-73865239,0,"P.S./ I.S. 311 - QUEENS","98-11 44TH AVENUE"
1,1,0,"0dba8b86-30f4-ea11-b882-24ee9a37d45c","P.S. 204 Vince Lombardi - K204 - K204 - 20K204 - 8101 15 AVENUE","0eba8b86-30f4-ea11-b882-24ee9a37d45c",-74006137,0,"P.S. 204 - BROOKLYN","8101 15 AVENUE"
2,0,2,"db454b50-32f4-ea11-b882-24ee9a37d45c","M.S. 358 - Q358 - Q314 - 28Q358 - 88-08 164TH STREET","d5454b50-32f4-ea11-b882-24ee9a37d45c",-73797981,40708698,"P.S./ I.S. 314 - Queens","88-08 164TH STREET"
1,0,1,"09e0ede7-49fb-ea11-b883-24ee9a37d459","Williamsburg Y Head Start - KBWW - KBUN -  - 64 Division Avenue","0ae0ede7-49fb-ea11-b883-24ee9a37d459",0,0,"Williamsburg Y Head Start","64 Division Avenue"
1,0,1,"0e02926e-32f4-ea11-b882-24ee9a37d45c","Frederick Douglass Academy VI High School - Q260 - Q465 - 27Q260 - 8-21 BAY 25 STREET","0b02926e-32f4-ea11-b882-24ee9a37d45c",-73763995,40601537,"FAR ROCKAWAY HS - Q","8-21 BAY 25 STREET"
1,0,1,"4a0d6d19-33f4-ea11-b882-24ee9a37d45c","P.S. 110 Theodore Schoenfeld - X110 - X110 - 09X110 - 580 CROTONA PARK SOUTH","420d6d19-33f4-ea11-b882-24ee9a37d45c",-73900654,40834470,"P.S. 110 - BRONX","580 CROTONA PARK SOUTH"
1,0,1,"1ea6ba98-31f4-ea11-b882-24ee9a37d45c","Union Square Academy for Health Sciences - M533 - M460 - 02M533 - 40 IRVING PLACE","16a6ba98-31f4-ea11-b882-24ee9a37d45c",-73987064,40735361,"WASHINGTON IRVING HS - MANHATTAN","40 IRVING PLACE"
1,1,0,"38005d7a-31f4-ea11-b882-24ee9a37d45c","J.H.S. 167 Robert F. Wagner - M167 - M167 - 02M167 - 220 EAST 76 STREET","39005d7a-31f4-ea11-b882-24ee9a37d45c",-73957827,40771541,"I.S. 167 - MANHATTAN","220 EAST 76 STREET"
2,1,1,"db315367-30f4-ea11-b882-24ee9a37d45c","P.S. 132 The Conselyea School - K132 - K132 - 14K132 - 320 MANHATTAN AVENUE","dc315367-30f4-ea11-b882-24ee9a37d45c",-73945663,40714772,"P.S. 132 - BROOKLYN","320 MANHATTAN AVENUE"
1,1,0,"5a29a44a-ebf6-ea11-b883-24ee9a37d459","LYFE - M984 - K871 - 79M984 - 67-69 SCHERMERHORN STREET","0004d718-31f4-ea11-b882-24ee9a37d45c",-73990844,0,"Pathways to Graduation @ Schermerhorn Street","67-69 SCHERMERHORN STREET"
1,0,1,"3aa10a44-32f4-ea11-b882-24ee9a37d45c","P.S. 254 - The Rosa Parks School - Q254 - Q254 - 27Q254 - 84-40 101 STREET","39a10a44-32f4-ea11-b882-24ee9a37d45c",-73847886,40697200,"P.S. 254 - QUEENS","84-40 101 STREET"
3,3,0,"d1b36d80-30f4-ea11-b882-24ee9a37d45c","P.S. 186 Dr. Irving A Gladstone - K186 - K186 - 20K186 - 7601 19 AVENUE","d2b36d80-30f4-ea11-b882-24ee9a37d45c",-73994258,40610917,"P.S. 186 - BROOKLYN","7601 19 AVENUE"
1,0,1,"b732c3fb-eaf6-ea11-b883-24ee9a37d459","District 27 Pre-K Center - Q336 - Q473 - 27Q336 - 133-40 79TH STREET","2c02926e-32f4-ea11-b882-24ee9a37d45c",-73857176,40671903,"3K CENTER @ 133-40 79TH STREET - QUEENS","133-40 79TH STREET"
1,0,1,"e5e0a4fb-ebf6-ea11-b883-24ee9a37d459","P.S. 723 - X723 - X338 - 75X723 - 1780 Dr. Martin Luther King Jr. Blvd","e3ba3c50-33f4-ea11-b882-24ee9a37d45c",-73915217,40849416,"MORRIS HEIGHTS EDUCATIONAL COMPLEX - BRONX","1780 Dr. Martin Luther King Jr. Blvd"
1,0,1,"fef22ce2-31f4-ea11-b882-24ee9a37d45c","P.S. 011 Kathryn Phelan - Q011 - Q011 - 30Q011 - 54-25 SKILLMAN AVENUE","fff22ce2-31f4-ea11-b882-24ee9a37d45c",-73909032,40746127,"P.S. 11 - QUEENS","54-25 SKILLMAN AVENUE"
1,0,1,"6f8d8486-31f4-ea11-b882-24ee9a37d45c","Harlem Village Academy West Charter School - M709 - M194 - 84M709 - 244 WEST 144 STREET","708d8486-31f4-ea11-b882-24ee9a37d45c",-73941111,40821208,"P.S. 194 - MANHATTAN","244 WEST 144 STREET"
1,1,0,"585bc58c-30f4-ea11-b882-24ee9a37d45c","P.S. 217 Colonel David Marcus School - K217 - K217 - 22K217 - 1100 Newkirk Avenue","545bc58c-30f4-ea11-b882-24ee9a37d45c",-73966442,40633482,"P.S. 217 - BROOKLYN","1100 Newkirk Avenue"
1,0,1,"28474313-33f4-ea11-b882-24ee9a37d45c","P.S. 091 Bronx - X091 - X091 - 10X091 - 2200 AQUEDUCT AVENUE","29474313-33f4-ea11-b882-24ee9a37d45c",-73907494,40858286,"P.S. 91 - BRONX","2200 AQUEDUCT AVENUE"
1,0,1,"e4f57030-30f4-ea11-b882-24ee9a37d45c","Ronald Edmonds Learning Center II - K484 - K012 - 17K484 - 430 HOWARD AVENUE","def57030-30f4-ea11-b882-24ee9a37d45c",-73920095,40673124,"P.S. 12 - BROOKLYN","430 HOWARD AVENUE"
1,1,0,"a7eb0e7b-33f4-ea11-b882-24ee9a37d45c","High School for Energy and Technology - X565 - X660 - 10X565 - 2474 CROTONA AVENUE","a3eb0e7b-33f4-ea11-b882-24ee9a37d45c",-73882487,40855392,"GRACE H. DODGE VOC HS - X","2474 CROTONA AVENUE"
3,0,3,"237eed06-32f4-ea11-b882-24ee9a37d45c","I.S. 093 Ridgewood - Q093 - Q093 - 24Q093 - 66-56 FOREST AVENUE","0f7eed06-32f4-ea11-b882-24ee9a37d45c",-73903057,40705609,"I.S. 93 - QUEENS","66-56 FOREST AVENUE"
1,0,1,"8436d900-33f4-ea11-b882-24ee9a37d45c","P.S. 062 Inocensio Casanova - X062 - X062 - 08X062 - 660 FOX STREET","8336d900-33f4-ea11-b882-24ee9a37d45c",-73900161,40813736,"P.S. 62 - BRONX","660 FOX STREET"
1,0,1,"19e63126-ebf6-ea11-b883-24ee9a37d459","P.S. 370 - K370 - K237 - 75K370 - 50 AVENUE P","5fa5db98-30f4-ea11-b882-24ee9a37d45c",-73986678,40606994,"LUCRETIA MARCIGLIANO CAMPUS - K","50 AVENUE P"
1,0,1,"f3a2f813-ebf6-ea11-b883-24ee9a37d459","P.S. 370 - K370 - K100 - 75K370 - 2951 WEST 3 STREET","ca0d3c5b-30f4-ea11-b882-24ee9a37d45c",-73970830,40577591,"P.S. 100 - BROOKLYN","2951 WEST 3 STREET"
1,0,1,"cd689025-33f4-ea11-b882-24ee9a37d45c","Success Academy Charter School - Bronx 4 - X464 - X131 - 84X464 - 885 Bolton Avenue","c8689025-33f4-ea11-b882-24ee9a37d45c",-73859998,0,"I.S. 131 - BRONX","885 Bolton Avenue"
1,1,0,"4b0b210d-33f4-ea11-b882-24ee9a37d45c","P.S. 083 Donald Hertz - X083 - X083 - 11X083 - 950 RHINELANDER AVENUE","4c0b210d-33f4-ea11-b882-24ee9a37d45c",-73858769,40849176,"P.S. 83 - BRONX","950 RHINELANDER AVENUE"
1,0,1,"82f4a0ef-eaf6-ea11-b883-24ee9a37d459","The Little Brooklyn Pre-K Center - K767 - K749 - 15K767 - 173-177 25TH STREET","492f7d06-31f4-ea11-b882-24ee9a37d45c",-73998973,0,"PRE-K CENTER @25TH STREET - BROOKLYN","173-177 25TH STREET"
2,2,0,"458dbfcf-30f4-ea11-b882-24ee9a37d45c","Leaders High School - K572 - K400 - 21K572 - 2630 BENSON AVENUE","3a8dbfcf-30f4-ea11-b882-24ee9a37d45c",-73986313,40593028,"Lafayette Educational Campus","2630 BENSON AVENUE"
1,1,0,"c70d3c5b-30f4-ea11-b882-24ee9a37d45c","Success Academy Charter School - Bensonhurst - K772 - K096 - 84K772 - 99 AVENUE P","c10d3c5b-30f4-ea11-b882-24ee9a37d45c",-73984985,40608135,"I.S. 96 - BROOKLYN","99 AVENUE P"
2,2,0,"4dfdc1bd-32f4-ea11-b882-24ee9a37d45c","P.S. 11 Thomas Dongan School - R011 - R011 - 31R011 - 51 Jefferson Street","4efdc1bd-32f4-ea11-b882-24ee9a37d45c",-74098252,40590887,"P.S. 11 - STATEN ISLAND","51 Jefferson Street"
1,0,1,"1eaf0313-32f4-ea11-b882-24ee9a37d45c","P.S. 136 Roy Wilkins - Q136 - Q136 - 29Q136 - 201-15 115 AVENUE","1faf0313-32f4-ea11-b882-24ee9a37d45c",-73752694,40698940,"P.S. 136 - QUEENS","201-15 115 AVENUE"
3,3,0,"ed1aad3c-30f4-ea11-b882-24ee9a37d45c","P.S. 029 John M. Harrigan - K029 - K029 - 15K029 - 425 HENRY STREET","ee1aad3c-30f4-ea11-b882-24ee9a37d45c",-73997447,40686843,"P.S. 29 - BROOKLYN","425 HENRY STREET"
3,3,0,"0d0410ca-32f4-ea11-b882-24ee9a37d45c","The Stephanie A. Vierno School - R041 - R041 - 31R041 - 216 CLAWSON STREET","0e0410ca-32f4-ea11-b882-24ee9a37d45c",-74108492,40573599,"P.S. 41 - STATEN ISLAND","216 CLAWSON STREET"
1,1,0,"b269c231-32f4-ea11-b882-24ee9a37d45c","P.S./I.S. 208 - Q208 - Q208 - 29Q208 - 74-30 COMMONWEALTH BLVD","ab69c231-32f4-ea11-b882-24ee9a37d45c",-73727632,40744276,"P.S./I.S. 208 - QUEENS","74-30 COMMONWEALTH BLVD"
1,1,0,"d5e0838c-31f4-ea11-b882-24ee9a37d45c","Lower Manhattan Community Middle School - M896 - M282 - 02M896 - 26 BROADWAY","d1e0838c-31f4-ea11-b882-24ee9a37d45c",-74013303,40705688,"BROADWAY EDUCATION CAMPUS - M","26 BROADWAY"
3,0,3,"39474313-33f4-ea11-b882-24ee9a37d45c","P.S. 095 Sheila Mencher - X095 - X095 - 10X095 - 3961 HILLMAN AVENUE","34474313-33f4-ea11-b882-24ee9a37d45c",-73891664,40883049,"P.S. 95 - BRONX","3961 HILLMAN AVENUE"
3,3,0,"c98442ee-31f4-ea11-b882-24ee9a37d45c","P.S. 032 State Street - Q032 - Q032 - 25Q032 - 171-11 35 AVENUE","ca8442ee-31f4-ea11-b882-24ee9a37d45c",-73794323,40765459,"P.S. 32 - QUEENS","171-11 35 AVENUE"
1,0,1,"7e886843-31f4-ea11-b882-24ee9a37d45c","P.S. 004 Duke Ellington - M004 - M004 - 06M004 - 500 WEST 160 STREET","7f886843-31f4-ea11-b882-24ee9a37d45c",-73941594,40834877,"P.S. 4 - MANHATTAN","500 WEST 160 STREET"
3,1,2,"3ea10a44-32f4-ea11-b882-24ee9a37d45c","Pioneer Academy - Q307 - Q260 - 24Q307 - 40-20 100TH STREET","3da10a44-32f4-ea11-b882-24ee9a37d45c",-73865787,0,"P.S. 307- QUEENS","40-20 100TH STREET"
1,1,0,"59953aac-ebf6-ea11-b883-24ee9a37d459","Mosaic Pre-K Center - Q331 - Q422 - 24Q331 - 108-18 ROOSEVELT AVENUE","b5b66262-32f4-ea11-b882-24ee9a37d45c",-73857960,0,"PRE-K @108-18 ROOSEVELT AVENUE - QUEENS","108-18 ROOSEVELT AVENUE"
1,1,0,"2502926e-32f4-ea11-b882-24ee9a37d45c","Jamaica Gateway to the Sciences - Q350 - Q470 - 28Q350 - 167-01 GOTHIC DRIVE","1f02926e-32f4-ea11-b882-24ee9a37d45c",-73798658,40714551,"JAMAICA HS - Q","167-01 GOTHIC DRIVE"
