"TotalCases","StudentCases","EmployeeCases","nycsr_locationsiteid","nycsr_sitename","nycsr_building.nycsr_buildingid","nycsr_building.nycsr_longitude","nycsr_building.nycsr_latitude","nycsr_building.nycsr_buildingname","nycsr_building.nycsr_address"
5,2,3,"ed21d292-30f4-ea11-b882-24ee9a37d45c","J.H.S. 227 Edward B. Shallow - K227 - K227 - 20K227 - 6500 16 AVENUE","ee21d292-30f4-ea11-b882-24ee9a37d45c",-73995961,40622102,"I.S. 227 - BROOKLYN","6500 16 AVENUE"
2,1,1,"64977d2b-32f4-ea11-b882-24ee9a37d45c","J.H.S. 185 Edward Bleeker - Q185 - Q185 - 25Q185 - 147-26 25 DRIVE","ae0e6e25-32f4-ea11-b882-24ee9a37d45c",-73818607,40774906,"J.H.S. 185 - QUEENS","147-26 25 DRIVE"
1,1,0,"21b4977a-32f4-ea11-b882-24ee9a37d45c","International High School at LaGuardia Community College - Q530 - Q520 - 24Q530 - 45-35 VAN DAM STREET","22b4977a-32f4-ea11-b882-24ee9a37d45c",-73933316,40743253,"MIDDLE COLLEGE CAMPUS - QUEENS","45-35 VAN DAM STREET"
2,2,0,"0f68ee1e-31f4-ea11-b882-24ee9a37d45c","P.S. 230 Doris L. Cohen - K230 - K908 - 15K230 - 425 Mcdonald Avenue","1068ee1e-31f4-ea11-b882-24ee9a37d45c",-73979161,40643512,"P.S. 230 ANNEX - BROOKLYN","425 Mcdonald Avenue"
4,0,4,"f721d292-30f4-ea11-b882-24ee9a37d45c","P.S. 230 Doris L. Cohen - K230 - K230 - 15K230 - 1 ALBEMARLE ROAD","f321d292-30f4-ea11-b882-24ee9a37d45c",-73980515,40645609,"P.S. 230 - BROOKLYN","1 ALBEMARLE ROAD"
4,2,2,"d60d3c5b-30f4-ea11-b882-24ee9a37d45c","P.S. 101 The Verrazano - K101 - K101 - 21K101 - 8696 24 Avenue","d70d3c5b-30f4-ea11-b882-24ee9a37d45c",-73991962,40597379,"P.S. 101 - BROOKLYN","8696 24 Avenue"
1,0,1,"bf8fd48d-ebf6-ea11-b883-24ee9a37d459","P.S. Q993 - Q993 - Q072 - 75Q993 - 133-25 GUY R BREWER BOULEVARD","852f77fa-31f4-ea11-b882-24ee9a37d45c",-73775643,40675014,"J.H.S. 72 - QUEENS","133-25 GUY R BREWER BOULEVARD"
5,4,1,"df8521d0-32f4-ea11-b882-24ee9a37d45c","P.S. 048 William G. Wilcox - R048 - R071 - 31R048 - 1050 Targee Street","db8521d0-32f4-ea11-b882-24ee9a37d45c",-74091239,40603492,"P.S./I.S. 48 - Staten Island","1050 Targee Street"
1,1,0,"cc0d3c5b-30f4-ea11-b882-24ee9a37d45c","P.S. 97 The Highlawn - K097 - K097 - 21K097 - 1846 West 13 Street","cd0d3c5b-30f4-ea11-b882-24ee9a37d45c",-73985570,40601191,"P.S. 97 - BROOKLYN","1846 West 13 Street"
4,2,2,"6034aa92-31f4-ea11-b882-24ee9a37d45c","P.S. 138 - M138 - M380 - 75M138 - 508 WEST 153RD STREET","6134aa92-31f4-ea11-b882-24ee9a37d45c",-73944846,40830415,"P.S. 380- MANHATTAN","508 WEST 153RD STREET"
1,1,0,"39de5eb7-30f4-ea11-b882-24ee9a37d45c","P.S. 297 Abraham Stockton - K297 - K297 - 14K297 - 700 PARK AVENUE","38de5eb7-30f4-ea11-b882-24ee9a37d45c",-73948166,40697377,"P.S. 297 - BROOKLYN","700 PARK AVENUE"
3,3,0,"13ba8b86-30f4-ea11-b882-24ee9a37d45c","P.S. 206 Joseph F Lamb - K206 - K206 - 22K206 - 2200 GRAVESEND NECK ROAD","14ba8b86-30f4-ea11-b882-24ee9a37d45c",-73948453,40596876,"P.S. 206 - BROOKLYN","2200 GRAVESEND NECK ROAD"
2,1,1,"a2886843-31f4-ea11-b882-24ee9a37d45c","Central Park East High School - M555 - M013 - 04M555 - 1573 MADISON AVENUE","98886843-31f4-ea11-b882-24ee9a37d45c",-73948488,40793649,"I.S. 13 - MANHATTAN","1573 MADISON AVENUE"
2,1,1,"810e6e25-32f4-ea11-b882-24ee9a37d45c","BELL Academy - Q294 - Q169 - 25Q294 - 18-25 212 STREET","820e6e25-32f4-ea11-b882-24ee9a37d45c",-73778430,40782331,"P.S. 169 - QUEENS","18-25 212 STREET"
3,1,2,"e7f22ce2-31f4-ea11-b882-24ee9a37d45c","I.S. 5 - The Walter Crowley Intermediate School - Q005 - Q005 - 24Q005 - 50-40 JACOBUS STREET","9adc32dc-31f4-ea11-b882-24ee9a37d45c",-73888133,40737405,"I.S. 5 - QUEENS","50-40 JACOBUS STREET"
1,1,0,"75d92255-30f4-ea11-b882-24ee9a37d45c","J.H.S. 088 Peter Rouget - K088 - K088 - 15K088 - 544 7TH AVENUE","76d92255-30f4-ea11-b882-24ee9a37d45c",-73988743,40660805,"I.S. 88 - BROOKLYN","544 7TH AVENUE"
5,4,1,"e09b4c1f-32f4-ea11-b882-24ee9a37d45c","P.S. 153 Maspeth Elem - Q153 - Q153 - 24Q153 - 60-02 60 LANE","e19b4c1f-32f4-ea11-b882-24ee9a37d45c",-73904463,40716296,"P.S. 153 - QUEENS","60-02 60 LANE"
1,1,0,"92977d2b-32f4-ea11-b882-24ee9a37d45c","P.S. 197 The Ocean School - Q197 - Q197 - 27Q197 - 825 HICKSVILLE ROAD","93977d2b-32f4-ea11-b882-24ee9a37d45c",-73744128,40599664,"P.S. 197 - QUEENS","825 HICKSVILLE ROAD"
1,1,0,"89283fb1-30f4-ea11-b882-24ee9a37d45c","Achievement First Brownsville Charter School - K626 - K292 - 84K626 - 301 VERMONT STREET","8a283fb1-30f4-ea11-b882-24ee9a37d45c",-73893319,40671601,"I.S. 292 - BROOKLYN","301 VERMONT STREET"
1,1,0,"b1eb6056-32f4-ea11-b882-24ee9a37d45c","August Martin High School - Q400 - Q400 - 27Q400 - 156-10 BAISLEY BOULEVARD","a9eb6056-32f4-ea11-b882-24ee9a37d45c",-73782684,40673949,"AUGUST MARTIN HS - QUEENS","156-10 BAISLEY BOULEVARD"
1,0,1,"038b0044-33f4-ea11-b882-24ee9a37d45c","Cornerstone Academy for Social Action - X189 - X189 - 11X189 - 3441 STEENWICK AVENUE","018b0044-33f4-ea11-b882-24ee9a37d45c",-73830616,40882778,"P.S./I.S. 189 - BRONX","3441 STEENWICK AVENUE"
1,1,0,"05af1f69-ebf6-ea11-b883-24ee9a37d459","District 2 Pre-K Center - M391 - M343 - 02M391 - 1 PECK SLIP","e7e0838c-31f4-ea11-b882-24ee9a37d45c",-74002407,40708774,"THE PECK SLIP SCHOOL - MANHATTAN","1 PECK SLIP"
2,2,0,"10ba8b86-30f4-ea11-b882-24ee9a37d45c","P.S. 205 Clarion - K205 - K205 - 20K205 - 6701 20 AVENUE","11ba8b86-30f4-ea11-b882-24ee9a37d45c",-73986792,40614737,"P.S. 205 - BROOKLYN","6701 20 AVENUE"
2,1,1,"ec968d36-30f4-ea11-b882-24ee9a37d45c","P.S. 024 - K024 - K024 - 15K024 - 427 38 STREET","ed968d36-30f4-ea11-b882-24ee9a37d45c",-74004533,40652832,"P.S. 24 - BROOKLYN","427 38 STREET"
4,2,2,"b269c231-32f4-ea11-b882-24ee9a37d45c","P.S./I.S. 208 - Q208 - Q208 - 29Q208 - 74-30 COMMONWEALTH BLVD","ab69c231-32f4-ea11-b882-24ee9a37d45c",-73727632,40744276,"P.S./I.S. 208 - QUEENS","74-30 COMMONWEALTH BLVD"
1,0,1,"1703cefa-32f4-ea11-b882-24ee9a37d45c","P.S. 043 Jonas Bronck - X043 - X043 - 07X043 - 165 BROWN PLACE","1803cefa-32f4-ea11-b882-24ee9a37d45c",-73921593,40806452,"P.S. 43 - BRONX","165 BROWN PLACE"
1,1,0,"43fdc1bd-32f4-ea11-b882-24ee9a37d45c","I.S. 007 Elias Bernstein - R007 - R007 - 31R007 - 1270 Huguenot Avenue","447c21b7-32f4-ea11-b882-24ee9a37d45c",-74186096,40522971,"I.S. 7 - STATEN ISLAND","1270 Huguenot Avenue"
2,0,2,"cd8521d0-32f4-ea11-b882-24ee9a37d45c","I.S. 061 William A Morris - R061 - R061 - 31R061 - 445 CASTLETON AVENUE","460410ca-32f4-ea11-b882-24ee9a37d45c",-74097941,40634497,"I.S. 61 - STATEN ISLAND","445 CASTLETON AVENUE"
3,3,0,"6c977d2b-32f4-ea11-b882-24ee9a37d45c","P.S. 188 Kingsbury - Q188 - Q188 - 26Q188 - 218-12 HARTLAND AVENUE","6d977d2b-32f4-ea11-b882-24ee9a37d45c",-73753985,40736063,"P.S. 188 - QUEENS","218-12 HARTLAND AVENUE"
4,4,0,"989c11e8-30f4-ea11-b882-24ee9a37d45c","Millennium Brooklyn HS - K684 - K460 - 15K684 - 237 7 AVENUE","929c11e8-30f4-ea11-b882-24ee9a37d45c",-73978580,40669255,"John Jay Educational Campus","237 7 AVENUE"
1,0,1,"c2fc24e8-31f4-ea11-b882-24ee9a37d45c","World Journalism Preparatory: A College Board School - Q285 - Q025 - 25Q285 - 34-65 192 STREET","befc24e8-31f4-ea11-b882-24ee9a37d45c",-73789365,40764884,"J.H.S. 25 - QUEENS","34-65 192 STREET"
6,5,1,"ebb98b86-30f4-ea11-b882-24ee9a37d45c","P.S. 194 Raoul Wallenberg - K194 - K194 - 22K194 - 3117 AVENUE W","ecb98b86-30f4-ea11-b882-24ee9a37d45c",-73934163,40598069,"P.S. 194 - BROOKLYN","3117 AVENUE W"
3,3,0,"410b210d-33f4-ea11-b882-24ee9a37d45c","P.S. 081 Robert J. Christen - X081 - X081 - 10X081 - 5550 RIVERDALE AVENUE","420b210d-33f4-ea11-b882-24ee9a37d45c",-73904657,40903275,"P.S. 81 - BRONX","5550 RIVERDALE AVENUE"
2,1,1,"d38521d0-32f4-ea11-b882-24ee9a37d45c","The Kathleen Grimm School for Leadership and Sustainability - R062 - R062 - 31R062 - 644 Bloomingdale Road","d48521d0-32f4-ea11-b882-24ee9a37d45c",-74217934,40541563,"K.GRIMM SCL FOR LDRSHP&SUSTAINABLTY@SANDY GR -S.I.","644 Bloomingdale Road"
10,3,7,"e38521d0-32f4-ea11-b882-24ee9a37d45c","I.S. 072 Rocco Laurie - R072 - R072 - 31R072 - 33 FERNDALE AVENUE","e48521d0-32f4-ea11-b882-24ee9a37d45c",-74158618,40592132,"I.S. 72 - STATEN ISLAND","33 FERNDALE AVENUE"
1,0,1,"e577bb9f-33f4-ea11-b882-24ee9a37d45c","Validus Preparatory Academy - X263 - X970 - 09X263 - 1595 BATHGATE AVENUE","e177bb9f-33f4-ea11-b882-24ee9a37d45c",-73901774,40839508,"BATHGATE HS - BRONX","1595 BATHGATE AVENUE"
5,4,1,"6ce2635c-32f4-ea11-b882-24ee9a37d45c","Bayside High School - Q495 - Q405 - 26Q495 - 32-24 CORPORAL KENNEDY STREET","6be2635c-32f4-ea11-b882-24ee9a37d45c",-73781041,40771398,"BAYSIDE HS - Q","32-24 CORPORAL KENNEDY STREET"
2,2,0,"422f7d06-31f4-ea11-b882-24ee9a37d45c","P.S. 245 - K245 - K735 - 22K245 - 249 EAST 17TH STREET","432f7d06-31f4-ea11-b882-24ee9a37d45c",-73962743,40644927,"P.S. 245 - BROOKLYN","249 EAST 17TH STREET"
3,1,2,"3b0d6d19-33f4-ea11-b882-24ee9a37d45c","P.S. 106 Parkchester - X106 - X106 - 11X106 - 1514 OLMSTEAD AVENUE","3c0d6d19-33f4-ea11-b882-24ee9a37d45c",-73854823,40836974,"P.S. 106 - BRONX","1514 OLMSTEAD AVENUE"
6,4,2,"307eed06-32f4-ea11-b882-24ee9a37d45c","P.S. 097 Forest Park - Q097 - Q097 - 27Q097 - 85-52 85 STREET","317eed06-32f4-ea11-b882-24ee9a37d45c",-73860031,40694232,"P.S. 97 - QUEENS","85-52 85 STREET"
2,0,2,"68f4a0ef-eaf6-ea11-b883-24ee9a37d459","P.S. K811 Connie Lekas School - K811 - K286 - 75K811 - 2525 HARING STREET","6e283fb1-30f4-ea11-b882-24ee9a37d45c",-73938610,40591132,"P.S. 811 (OLD P286) - BROOKLYN","2525 HARING STREET"
1,1,0,"512b3eee-30f4-ea11-b882-24ee9a37d45c","Fort Hamilton High School - K490 - K490 - 20K490 - 8301 SHORE ROAD","522b3eee-30f4-ea11-b882-24ee9a37d45c",-74038103,40626827,"FORT HAMILTON HS - K","8301 SHORE ROAD"
3,2,1,"f6d10307-33f4-ea11-b882-24ee9a37d45c","P.S. 072 Dr. William Dorney - X072 - X072 - 08X072 - 2951 DEWEY AVENUE","f4d10307-33f4-ea11-b882-24ee9a37d45c",-73818172,40823237,"P.S. 72 - BRONX","2951 DEWEY AVENUE"
2,0,2,"fb8ac007-ebf6-ea11-b883-24ee9a37d459","P.S. X721 - Stephen McSweeney School - X721 - X722 - 75X721 - 2697 WESTCHESTER AVENUE","06a31781-33f4-ea11-b882-24ee9a37d45c",-73839114,40842725,"P.S. 721 (OTC) - BRONX","2697 WESTCHESTER AVENUE"
1,0,1,"76e2635c-32f4-ea11-b882-24ee9a37d45c","P.S. Q256 - Q256 - Q410 - 75Q256 - 100-00 BEACH CHANNEL DRIVE","71e2635c-32f4-ea11-b882-24ee9a37d45c",-73825317,40586012,"Beach Channel Educational Campus","100-00 BEACH CHANNEL DRIVE"
3,2,1,"cbe8ce00-32f4-ea11-b882-24ee9a37d45c","I.S. 73 - The Frank Sansivieri Intermediate School - Q073 - Q073 - 24Q073 - 70-02 54 AVENUE","cce8ce00-32f4-ea11-b882-24ee9a37d45c",-73893318,40728558,"I.S. 73 - QUEENS","70-02 54 AVENUE"
2,1,1,"27005d7a-31f4-ea11-b882-24ee9a37d45c","P.S. 163 Alfred E. Smith - M163 - M163 - 03M163 - 163 West 97 Street","26005d7a-31f4-ea11-b882-24ee9a37d45c",-73968470,40795163,"P.S. 163 - MANHATTAN","163 West 97 Street"
1,0,1,"b6fab455-31f4-ea11-b882-24ee9a37d45c","University Neighborhood Middle School - M332 - M056 - 01M332 - 220 HENRY STREET","affab455-31f4-ea11-b882-24ee9a37d45c",-73986051,40713362,"J.H.S. 56 - MANHATTAN","220 HENRY STREET"
2,1,1,"b5b36d80-30f4-ea11-b882-24ee9a37d45c","P.S. 179 Kensington - K179 - K179 - 20K179 - 202 AVENUE C","13d1de79-30f4-ea11-b882-24ee9a37d45c",-73977260,40640127,"P.S. 179 - BROOKLYN","202 AVENUE C"
2,1,1,"240b210d-33f4-ea11-b882-24ee9a37d45c","P.S. 076 The Bennington School - X076 - X076 - 11X076 - 900 ADEE AVENUE","250b210d-33f4-ea11-b882-24ee9a37d45c",-73860928,40869059,"P.S. 76 - BRONX","900 ADEE AVENUE"
2,1,1,"e68a0044-33f4-ea11-b882-24ee9a37d45c","I.S. 181 Pablo Casals - X181 - X181 - 11X181 - 800 BAYCHESTER AVENUE","e78a0044-33f4-ea11-b882-24ee9a37d45c",-73831669,40874035,"I.S. 181 - BRONX","800 BAYCHESTER AVENUE"
3,2,1,"2b0410ca-32f4-ea11-b882-24ee9a37d45c","P.S. 050 Frank Hankinson - R050 - R050 - 31R050 - 200 ADELAIDE AVENUE","2c0410ca-32f4-ea11-b882-24ee9a37d45c",-74124332,40560954,"P.S. 50 - STATEN ISLAND","200 ADELAIDE AVENUE"
2,2,0,"27eabc42-30f4-ea11-b882-24ee9a37d45c","M.S. 51 William Alexander - K051 - K051 - 15K051 - 350 5 AVENUE","28eabc42-30f4-ea11-b882-24ee9a37d45c",-73985050,40672358,"I.S. 51 - BROOKLYN","350 5 AVENUE"
5,4,1,"d2b66262-32f4-ea11-b882-24ee9a37d45c","Forest Hills High School - Q440 - Q440 - 28Q440 - 67-01 110 STREET","d3b66262-32f4-ea11-b882-24ee9a37d45c",-73843972,40730017,"FOREST HILLS HS - Q","67-01 110 STREET"
2,2,0,"4b0b210d-33f4-ea11-b882-24ee9a37d45c","P.S. 083 Donald Hertz - X083 - X083 - 11X083 - 950 RHINELANDER AVENUE","4c0b210d-33f4-ea11-b882-24ee9a37d45c",-73858769,40849176,"P.S. 83 - BRONX","950 RHINELANDER AVENUE"
4,4,0,"6541e65b-31f4-ea11-b882-24ee9a37d45c","New York City Lab Middle School for Collaborative Studies - M312 - M070 - 02M312 - 333 WEST 17 STREET","defab455-31f4-ea11-b882-24ee9a37d45c",-74002222,40742512,"I.S. 70 - MANHATTAN","333 WEST 17 STREET"
2,1,1,"b69c11e8-30f4-ea11-b882-24ee9a37d45c","Academy for Excellence in Leadership - K403 - K480 - 32K403 - 400 IRVING AVENUE","b39c11e8-30f4-ea11-b882-24ee9a37d45c",-73911751,40696457,"BUSHWICK EDUCATIONAL CAMPUS - K","400 IRVING AVENUE"
1,0,1,"7aa9d9c3-32f4-ea11-b882-24ee9a37d45c","P.S. 029 Bardwell - R029 - R029 - 31R029 - 1581 VICTORY BOULEVARD","7ba9d9c3-32f4-ea11-b882-24ee9a37d45c",-74116197,40614039,"P.S. 29 - STATEN ISLAND","1581 VICTORY BOULEVARD"
2,0,2,"42a10a44-32f4-ea11-b882-24ee9a37d45c","New York City Academy for Discovery - Q306 - Q262 - 27Q306 - 95-16 89TH AVENUE","43a10a44-32f4-ea11-b882-24ee9a37d45c",-73848577,40691482,"P.S. 262 - QUEENS","95-16 89TH AVENUE"
6,5,1,"5d07e99e-31f4-ea11-b882-24ee9a37d45c","Stuyvesant High School - M475 - M477 - 02M475 - 345 CHAMBERS STREET","5c07e99e-31f4-ea11-b882-24ee9a37d45c",-74013921,40718025,"STUYVESANT HS (NEW) - MANHATTAN","345 CHAMBERS STREET"
1,1,0,"e880b5c9-df1e-eb11-b885-24ee9a37d45c","MS 936 Arts Off 3rd - K936 - K746 - 20K936 - 270 59th Street","e980b5c9-df1e-eb11-b885-24ee9a37d45c",-74020748,40642914,"P.S. @ 270 59TH STREET- BROOKLYN","270 59th Street"
2,0,2,"dc8442ee-31f4-ea11-b882-24ee9a37d45c","Jamaica Children's School - Q312 - Q040 - 28Q312 - 109-20 Union Hall Street","dd8442ee-31f4-ea11-b882-24ee9a37d45c",-73790975,40693559,"P.S. 40 (D28) - QUEENS","109-20 Union Hall Street"
1,1,0,"87d95d3c-4afb-ea11-b883-24ee9a37d459","Watson Day Care Center - XAKB - XAGR -  - 1880 WATSON AVENUE","88d95d3c-4afb-ea11-b883-24ee9a37d459",0,0,"PRYOR, LEONTINE L. DAY CARE CENTER","1880 WATSON AVENUE"
1,1,0,"039c4c1f-32f4-ea11-b882-24ee9a37d45c","P.S. 163 Flushing Heights - Q163 - Q163 - 25Q163 - 159-01 59 AVENUE","049c4c1f-32f4-ea11-b882-24ee9a37d45c",-73808765,40741107,"P.S. 163 - QUEENS","159-01 59 AVENUE"
1,0,1,"0baf0313-32f4-ea11-b882-24ee9a37d45c","P.S. 130 - Q130 - Q130 - 25Q130 - 200-01 42 AVENUE","04af0313-32f4-ea11-b882-24ee9a37d45c",-73784009,40760219,"P.S. 130 - QUEENS","200-01 42 AVENUE"
1,0,1,"fa201dab-30f4-ea11-b882-24ee9a37d45c","P.S. 282 Park Slope - K282 - K282 - 13K282 - 180 6 Avenue","f8201dab-30f4-ea11-b882-24ee9a37d45c",-73977983,40676649,"P.S. 282 - BROOKLYN","180 6 Avenue"
1,0,1,"3b2682ef-ebf6-ea11-b883-24ee9a37d459","P.S. 723 - X723 - X099 - 75X723 - 1180 REV. J.A. POLITE AVE.","4a474313-33f4-ea11-b882-24ee9a37d45c",-73896925,40827539,"REV. J.A. POLITE AVE SCHOOL CAMPUS - BRONX","1180 REV. J.A. POLITE AVE."
2,0,2,"69fdc1bd-32f4-ea11-b882-24ee9a37d45c","P.S. 022 Graniteville - R022 - R022 - 31R022 - 1860 Forest Avenue","6afdc1bd-32f4-ea11-b882-24ee9a37d45c",-74150544,40624847,"P.S. 22 - STATEN ISLAND","1860 Forest Avenue"
1,1,0,"2da198c3-30f4-ea11-b882-24ee9a37d45c","P.S. 345 Patrolman Robert Bolden - K345 - K345 - 19K345 - 111 BERRIMAN STREET","2ca198c3-30f4-ea11-b882-24ee9a37d45c",-73879886,40676207,"P.S. 345 - BROOKLYN","111 BERRIMAN STREET"
1,1,0,"cb689025-33f4-ea11-b882-24ee9a37d45c","Soundview Academy for Culture and Scholarship - X448 - X131 - 08X448 - 885 Bolton Avenue","c8689025-33f4-ea11-b882-24ee9a37d45c",-73859998,40822925,"I.S. 131 - BRONX","885 Bolton Avenue"
2,1,1,"08cf496e-31f4-ea11-b882-24ee9a37d45c","P.S. 130 Hernando De Soto - M130 - M130 - 02M130 - 143 BAXTER STREET","09cf496e-31f4-ea11-b882-24ee9a37d45c",-73998326,40718660,"P.S. 130 - MANHATTAN","143 BAXTER STREET"
1,1,0,"14e85c61-30f4-ea11-b882-24ee9a37d45c","P.S. 110 The Monitor - K110 - K110 - 14K110 - 124 MONITOR STREET","e50d3c5b-30f4-ea11-b882-24ee9a37d45c",-73941926,40723743,"P.S. 110 - BROOKLYN","124 MONITOR STREET"
2,2,0,"e68521d0-32f4-ea11-b882-24ee9a37d45c","I.S. 075 Frank D. Paulo - R075 - R075 - 31R075 - 455 HUGUENOT AVENUE","e28521d0-32f4-ea11-b882-24ee9a37d45c",-74197033,40544535,"I.S. 75 - STATEN ISLAND","455 HUGUENOT AVENUE"
1,1,0,"1eb4977a-32f4-ea11-b882-24ee9a37d45c","Townsend Harris High School - Q525 - Q515 - 25Q525 - 149-11 MELBOURNE AVENUE","1db4977a-32f4-ea11-b882-24ee9a37d45c",-73821532,40737038,"TOWNSEND HARRIS HS - Q","149-11 MELBOURNE AVENUE"
2,2,0,"07fc3df4-30f4-ea11-b882-24ee9a37d45c","John Dewey High School - K540 - K540 - 21K540 - 50 AVENUE X","05fc3df4-30f4-ea11-b882-24ee9a37d45c",-73981925,40588070,"JOHN DEWEY HS - K","50 AVENUE X"
1,1,0,"e4201dab-30f4-ea11-b882-24ee9a37d45c","P.S. 277 Gerritsen Beach - K277 - K277 - 22K277 - 2529 GERRITSEN AVENUE","e5201dab-30f4-ea11-b882-24ee9a37d45c",-73927850,40595798,"P.S. 277 - BROOKLYN","2529 GERRITSEN AVENUE"
1,0,1,"cb9452e9-8b23-ed11-b0a2-088e901ef405","P.S. Q224 - Q224 - Q314 - 75Q224 - 88-08 164TH STREET","d5454b50-32f4-ea11-b882-24ee9a37d45c",-73797981,40708698,"P.S./ I.S. 314 - Queens","88-08 164TH STREET"
1,0,1,"3c2f7d06-31f4-ea11-b882-24ee9a37d45c","Liberation Diploma Plus - K728 - K728 - 21K728 - 2865 West 19th Street","3b2f7d06-31f4-ea11-b882-24ee9a37d45c",-73985413,40576976,"LIBERATION DIPLOMA PLUS H.S. - K","2865 West 19th Street"
2,0,2,"0e02926e-32f4-ea11-b882-24ee9a37d45c","Frederick Douglass Academy VI High School - Q260 - Q465 - 27Q260 - 8-21 BAY 25 STREET","0b02926e-32f4-ea11-b882-24ee9a37d45c",-73763995,40601537,"FAR ROCKAWAY HS - Q","8-21 BAY 25 STREET"
4,4,0,"6ba5db98-30f4-ea11-b882-24ee9a37d45c","Mark Twain I.S. 239 for the Gifted & Talented - K239 - K239 - 21K239 - 2401 NEPTUNE AVENUE","6ca5db98-30f4-ea11-b882-24ee9a37d45c",-73992447,40578640,"I.S. 239 - BROOKLYN","2401 NEPTUNE AVENUE"
2,0,2,"897e21a6-ebf6-ea11-b883-24ee9a37d459","The Riverview School - Q277 - Q290 - 75Q277 - 55-20 METROPOLITAN AVENUE","24c73b4a-32f4-ea11-b882-24ee9a37d45c",-73908307,40713030,"THE GERALDINE FERRARO CAMPUS - QUEENS","55-20 METROPOLITAN AVENUE"
3,1,2,"1fa198c3-30f4-ea11-b882-24ee9a37d45c","Sunset Park Avenues Elementary School - K516 - K333 - 15K516 - 4222 4th Avenue","20a198c3-30f4-ea11-b882-24ee9a37d45c",-74008106,40650793,"P.S. 516 SUNSET PARK AVENUES ELEMENTARY SCHOOL - B","4222 4th Avenue"
3,3,0,"02ba8b86-30f4-ea11-b882-24ee9a37d45c","The Madeleine Brennan School - K201 - K201 - 20K201 - 8010 12 AVENUE","03ba8b86-30f4-ea11-b882-24ee9a37d45c",-74013749,40619043,"I.S. 201 - BROOKLYN","8010 12 AVENUE"
2,1,1,"4e2b3eee-30f4-ea11-b882-24ee9a37d45c","The Christa McAuliffe School\I.S. 187 - K187 - K486 - 20K187 - 1171 65 STREET","4f2b3eee-30f4-ea11-b882-24ee9a37d45c",-74003883,40627929,"I.S. 187 - BROOKLYN","1171 65 STREET"
4,4,0,"3a0410ca-32f4-ea11-b882-24ee9a37d45c","P.S. 055 Henry M. Boehm - R055 - R055 - 31R055 - 54 OSBORNE STREET","3b0410ca-32f4-ea11-b882-24ee9a37d45c",-74163037,40536625,"P.S. 55 - STATEN ISLAND","54 OSBORNE STREET"
1,0,1,"f0d27c6d-30f4-ea11-b882-24ee9a37d45c","School of Science & Technology - K152 - K152 - 22K152 - 725 EAST 23 STREET","efd27c6d-30f4-ea11-b882-24ee9a37d45c",-73954269,40632619,"P.S. 152 - BROOKLYN","725 EAST 23 STREET"
1,1,0,"1e06003e-32f4-ea11-b882-24ee9a37d45c","East-West School of International Studies - Q281 - Q237 - 25Q281 - 46-21 COLDEN STREET","1b06003e-32f4-ea11-b882-24ee9a37d45c",-73821402,40749430,"J.H.S. 237 - QUEENS","46-21 COLDEN STREET"
2,2,0,"1c1bad3c-30f4-ea11-b882-24ee9a37d45c","P.S./I.S. 045 Horace E. Greene - K045 - K045 - 32K045 - 84 SCHAEFER STREET","1d1bad3c-30f4-ea11-b882-24ee9a37d45c",-73910430,40686424,"P.S. 45 - BROOKLYN","84 SCHAEFER STREET"
1,0,1,"87e2635c-32f4-ea11-b882-24ee9a37d45c","Benjamin N. Cardozo High School - Q415 - Q415 - 26Q415 - 57-00 223RD STREET","86e2635c-32f4-ea11-b882-24ee9a37d45c",-73757271,40752343,"BENJAMIN N. CARDOZO HS - Q","57-00 223RD STREET"
1,1,0,"2baf0313-32f4-ea11-b882-24ee9a37d45c","P.S. 139 Rego Park - Q139 - Q139 - 28Q139 - 93-06 63 DRIVE","29af0313-32f4-ea11-b882-24ee9a37d45c",-73862561,40728012,"P.S. 139 - QUEENS","93-06 63 DRIVE"
1,0,1,"a872c880-32f4-ea11-b882-24ee9a37d45c","Queens Transition Center - Q752 - Q690 - 75Q752 - 116-25 GUY R BREWER BOULEVARD","a972c880-32f4-ea11-b882-24ee9a37d45c",-73783438,40685838,"HS FOR LAW ENFORCEMENT - QUEENS","116-25 GUY R BREWER BOULEVARD"
1,1,0,"515bc58c-30f4-ea11-b882-24ee9a37d45c","P.S. 215 Morris H. Weiss - K215 - K215 - 21K215 - 415 AVENUE S","505bc58c-30f4-ea11-b882-24ee9a37d45c",-73970171,40602722,"P.S. 215 - BROOKLYN","415 AVENUE S"
7,5,2,"f2ae0313-32f4-ea11-b882-24ee9a37d45c","P.S. 122 Mamie Fay - Q122 - Q122 - 30Q122 - 21-21 DITMARS BOULEVARD","cb2ff20c-32f4-ea11-b882-24ee9a37d45c",-73915785,40780507,"P.S. 122 - QUEENS","21-21 DITMARS BOULEVARD"
4,4,0,"c3c88e4f-31f4-ea11-b882-24ee9a37d45c","The Anderson School - M334 - M044 - 03M334 - 100 WEST 77 STREET","bfc88e4f-31f4-ea11-b882-24ee9a37d45c",-73977602,40780536,"I.S. 44 - MANHATTAN","100 WEST 77 STREET"
1,1,0,"82be7adc-32f4-ea11-b882-24ee9a37d45c","P.S. 65 The Academy of Innovative Learning - R065 - R829 - 31R065 - 98 GRANT STREET","83be7adc-32f4-ea11-b882-24ee9a37d45c",-74078337,40633666,"ARTHUR D. PHILLIPS SCHOOL - S.I.","98 GRANT STREET"
2,2,0,"ffbdf08c-32f4-ea11-b882-24ee9a37d45c","Baccalaureate School for Global Education - Q580 - Q798 - 30Q580 - 34-12 36 AVENUE","00bef08c-32f4-ea11-b882-24ee9a37d45c",-73926977,40754975,"BACCALAUREATE SCL FOR GLOBAL ED-Q","34-12 36 AVENUE"
2,2,0,"018bc007-ebf6-ea11-b883-24ee9a37d459","Bronx Charter School for Better Learning - X718 - X937 - 84X718 - 3740 BAYCHESTER AVENUE","20497593-33f4-ea11-b882-24ee9a37d45c",-73839288,40884371,"BX CHARTER SCH FOR BETTER LRNG - X","3740 BAYCHESTER AVENUE"
1,1,0,"ace657bd-30f4-ea11-b882-24ee9a37d45c","P.S. 321 William Penn - K321 - K321 - 15K321 - 180 7 AVENUE","ade657bd-30f4-ea11-b882-24ee9a37d45c",-73978633,40671816,"P.S. 321 - BROOKLYN","180 7 AVENUE"
2,2,0,"ef201dab-30f4-ea11-b882-24ee9a37d45c","M.S. 442 Carroll Gardens School for Innovation - K442 - K280 - 15K442 - 500 19 STREET","ed201dab-30f4-ea11-b882-24ee9a37d45c",-73983116,40656952,"PRE-K CENTER @ 500 19TH STREET - BROOKLYN","500 19 STREET"
3,2,1,"380d6d19-33f4-ea11-b882-24ee9a37d45c","P.S. 105 Sen Abraham Bernstein - X105 - X105 - 11X105 - 725 Brady Avenue","390d6d19-33f4-ea11-b882-24ee9a37d45c",-73866264,40853075,"P.S. 105 - BRONX","725 Brady Avenue"
2,2,0,"5de61462-31f4-ea11-b882-24ee9a37d45c","J.H.S. 104 Simon Baruch - M104 - M104 - 02M104 - 330 EAST 21 STREET","5ee61462-31f4-ea11-b882-24ee9a37d45c",-73981034,40735879,"I.S. 104 - MANHATTAN","330 EAST 21 STREET"
2,1,1,"c82ff20c-32f4-ea11-b882-24ee9a37d45c","P.S./M.S. 114 Belle Harbor - Q114 - Q114 - 27Q114 - 134-01 CRONSTON AVENUE","c12ff20c-32f4-ea11-b882-24ee9a37d45c",-73854364,40577552,"P.S. 114 - QUEENS","134-01 CRONSTON AVENUE"
2,0,2,"d9883319-32f4-ea11-b882-24ee9a37d45c","P.S. 143 Louis Armstrong - Q143 - Q143 - 24Q143 - 34-74 113 Street","d7883319-32f4-ea11-b882-24ee9a37d45c",-73855715,40755393,"P.S. 143 - QUEENS","34-74 113 Street"
1,1,0,"03b7c337-32f4-ea11-b882-24ee9a37d45c","J.H.S. 216 George J. Ryan - Q216 - Q216 - 26Q216 - 64-20 175 Street","04b7c337-32f4-ea11-b882-24ee9a37d45c",-73794501,40737188,"J.H.S. 216 - QUEENS","64-20 175 Street"
2,2,0,"77c280bd-31f4-ea11-b882-24ee9a37d45c","The Clinton School - M260 - M868 - 02M260 - 10 East 15th Street","78c280bd-31f4-ea11-b882-24ee9a37d45c",-73992727,40736526,"THE CLINTON SCHOOL - MANHATTAN","10 East 15th Street"
4,2,2,"752f77fa-31f4-ea11-b882-24ee9a37d45c","P.S. 068 Cambridge - Q068 - Q068 - 24Q068 - 59-09 SAINT FELIX AVENUE","762f77fa-31f4-ea11-b882-24ee9a37d45c",-73897372,40696961,"P.S. 68 - QUEENS","59-09 SAINT FELIX AVENUE"
1,1,0,"b42aa42b-33f4-ea11-b882-24ee9a37d45c","J.H.S. 144 Michelangelo - X144 - X144 - 11X144 - 2545 GUNTHER AVENUE","b22aa42b-33f4-ea11-b882-24ee9a37d45c",-73836525,40863842,"I.S. 144 - BRONX","2545 GUNTHER AVENUE"
1,1,0,"e39b4c1f-32f4-ea11-b882-24ee9a37d45c","P.S. 154 Queens - Q154 - Q154 - 25Q154 - 75-02 162 Street","d69b4c1f-32f4-ea11-b882-24ee9a37d45c",-73807750,40726473,"P.S. 154 - QUEENS","75-02 162 Street"
3,2,1,"d7f57030-30f4-ea11-b882-24ee9a37d45c","Public School 9 The Sarah Smith Garnet School - K009 - K009 - 13K009 - 80 UNDERHILL AVENUE","d8f57030-30f4-ea11-b882-24ee9a37d45c",-73966333,40678554,"P.S. 9 - BROOKLYN","80 UNDERHILL AVENUE"
1,1,0,"29a198c3-30f4-ea11-b882-24ee9a37d45c","P.S. 889 - K889 - K338 - 22K889 - 21 HINCKLEY PLACE","27a198c3-30f4-ea11-b882-24ee9a37d45c",-73971010,40644861,"P.S. 338 - Brooklyn","21 HINCKLEY PLACE"
1,1,0,"66b50aa5-30f4-ea11-b882-24ee9a37d45c","P.S. 261 Zipporiah Mills - K261 - K261 - 15K261 - 314 PACIFIC STREET","5fb50aa5-30f4-ea11-b882-24ee9a37d45c",-73988667,40687218,"P.S. 261 - BROOKLYN","314 PACIFIC STREET"
1,1,0,"8f0e6e25-32f4-ea11-b882-24ee9a37d45c","P.S. 173 Fresh Meadows - Q173 - Q173 - 26Q173 - 174-10 67 AVENUE","900e6e25-32f4-ea11-b882-24ee9a37d45c",-73795651,40734097,"P.S. 173 - QUEENS","174-10 67 AVENUE"
1,1,0,"cd315367-30f4-ea11-b882-24ee9a37d45c","P.S. 127 Mckinley Park - K127 - K127 - 20K127 - 7805 7 Avenue","ce315367-30f4-ea11-b882-24ee9a37d45c",-74018429,40623687,"P.S. 127 - BROOKLYN","7805 7 Avenue"
1,1,0,"9d476368-32f4-ea11-b882-24ee9a37d45c","Queens High School for Language Studies - Q241 - Q460 - 25Q241 - 35-01 UNION STREET","97476368-32f4-ea11-b882-24ee9a37d45c",-73826811,40764892,"FLUSHING HS - Q","35-01 UNION STREET"
1,1,0,"31005d7a-31f4-ea11-b882-24ee9a37d45c","P.S. 165 Robert E. Simon - M165 - M165 - 03M165 - 234 West 109 Street","2f005d7a-31f4-ea11-b882-24ee9a37d45c",-73965949,40802653,"P.S. 165 - MANHATTAN","234 West 109 Street"
1,0,1,"30c15a75-ebf6-ea11-b883-24ee9a37d459","Adult and Continuing Education - K755 - M827 - 79K755 - 500 8 AVENUE","576e70b7-31f4-ea11-b882-24ee9a37d45c",-73992405,40753038,"AUX. SERV-MAN. LEARNING CENTER - M","500 8 AVENUE"
3,3,0,"a8d810ab-31f4-ea11-b882-24ee9a37d45c","Success Academy Charter School - Hell's Kitchen - M170 - M625 - 84M170 - 439 WEST 49TH STREET","a9d810ab-31f4-ea11-b882-24ee9a37d45c",-73990318,40763655,"HS OF GRAPHIC COMMUNICATION ARTS-M","439 WEST 49TH STREET"
1,0,1,"197eed06-32f4-ea11-b882-24ee9a37d45c","P.S. 89Q: The Jose Peralta School of Dreamers - Q089 - Q089 - 24Q089 - 85-28 BRITTON AVENUE","1a7eed06-32f4-ea11-b882-24ee9a37d45c",-73879641,40745963,"P.S. 89 - QUEENS","85-28 BRITTON AVENUE"
2,2,0,"92283fb1-30f4-ea11-b882-24ee9a37d45c","Success Academy Charter School - Cobble Hill - K129 - K293 - 84K129 - 284 Baltic Street","91283fb1-30f4-ea11-b882-24ee9a37d45c",-73993293,40685006,"J.H.S. 293 - BROOKLYN","284 Baltic Street"
1,1,0,"ec201dab-30f4-ea11-b882-24ee9a37d45c","Pre-K Center at Bishop Ford School Site - K863 - K280 - 15K863 - 500 19 STREET","ed201dab-30f4-ea11-b882-24ee9a37d45c",-73983116,40656952,"PRE-K CENTER @ 500 19TH STREET - BROOKLYN","500 19 STREET"
3,1,2,"22d8cf12-31f4-ea11-b882-24ee9a37d45c","Success Academy Charter School - Bergen Beach - K781 - K864 - 84K781 - 3109 NEWKIRK AVENUE","23d8cf12-31f4-ea11-b882-24ee9a37d45c",-73947025,40640551,"P.S. 361 (OLD 89) - BROOKLYN","3109 NEWKIRK AVENUE"
1,0,1,"af32c3fb-eaf6-ea11-b883-24ee9a37d459","Success Academy Charter School - Rosedale - Q337 - Q374 - 84Q337 - 147-65 249th Street","8feb6056-32f4-ea11-b882-24ee9a37d45c",-73738793,40655811,"Success Academy - Rosedale","147-65 249th Street"
1,1,0,"790e6e25-32f4-ea11-b882-24ee9a37d45c","P.S. 166 Henry Gradstein - Q166 - Q166 - 30Q166 - 33-09 35 AVENUE","7a0e6e25-32f4-ea11-b882-24ee9a37d45c",-73926249,40757497,"P.S. 166 - QUEENS","33-09 35 AVENUE"
1,1,0,"3bebaa73-30f4-ea11-b882-24ee9a37d45c","P.S. 748 Brooklyn School for Global Scholars - K748 - K163 - 20K748 - 1664 BENSON AVENUE","3cebaa73-30f4-ea11-b882-24ee9a37d45c",-74007469,40606739,"P.S. 163 - BROOKLYN","1664 BENSON AVENUE"
1,1,0,"307c21b7-32f4-ea11-b882-24ee9a37d45c","I.S. R002 George L. Egbert - R002 - R002 - 31R002 - 333 Midland Avenue","2b7c21b7-32f4-ea11-b882-24ee9a37d45c",-74099685,40576728,"I.S. 2 - STATEN ISLAND","333 Midland Avenue"
2,2,0,"3088e6db-30f4-ea11-b882-24ee9a37d45c","Brooklyn Technical High School - K430 - K430 - 13K430 - 29 FT GREENE PLACE","3188e6db-30f4-ea11-b882-24ee9a37d45c",-73976435,40688896,"BROOKLYN TECH HS - K","29 FT GREENE PLACE"
1,0,1,"e7ba3c50-33f4-ea11-b882-24ee9a37d45c","P.S. 204 Morris Heights - X204 - X338 - 09X204 - 1780 Dr. Martin Luther King Jr. Blvd","e3ba3c50-33f4-ea11-b882-24ee9a37d45c",-73915217,40849416,"MORRIS HEIGHTS EDUCATIONAL COMPLEX - BRONX","1780 Dr. Martin Luther King Jr. Blvd"
1,1,0,"370410ca-32f4-ea11-b882-24ee9a37d45c","P.S. 054 Charles W. Leng - R054 - R054 - 31R054 - 1060 WILLOWBROOK ROAD","380410ca-32f4-ea11-b882-24ee9a37d45c",-74137259,40602779,"P.S. 54 - STATEN ISLAND","1060 WILLOWBROOK ROAD"
1,1,0,"516e70b7-31f4-ea11-b882-24ee9a37d45c","P.S. 527 - East Side School for Social Action - M527 - M816 - 02M527 - 323 EAST 91 STREET","526e70b7-31f4-ea11-b882-24ee9a37d45c",-73947856,40780652,"P.S. 527 - East Side School for Social Action","323 EAST 91 STREET"
1,1,0,"90bc9674-32f4-ea11-b882-24ee9a37d45c","Hillcrest High School - Q505 - Q505 - 28Q505 - 160-05 HIGHLAND AVENUE","8fbc9674-32f4-ea11-b882-24ee9a37d45c",-73803001,40709461,"HILLCREST HS - Q","160-05 HIGHLAND AVENUE"
1,0,1,"c08442ee-31f4-ea11-b882-24ee9a37d45c","P.S. 029 Queens - Q029 - Q029 - 25Q029 - 125-10 23 AVENUE","c18442ee-31f4-ea11-b882-24ee9a37d45c",-73842967,40778029,"P.S. 29 - QUEENS","125-10 23 AVENUE"
2,2,0,"af0e6e25-32f4-ea11-b882-24ee9a37d45c","P.S. 184 Flushing Manor - Q184 - Q184 - 25Q184 - 163-15 21 ROAD","b00e6e25-32f4-ea11-b882-24ee9a37d45c",-73799158,40778334,"P.S. 184 - QUEENS","163-15 21 ROAD"
1,1,0,"668946f4-31f4-ea11-b882-24ee9a37d45c","P.S. 049 Dorothy Bonawit Kole - Q049 - Q049 - 24Q049 - 63-60 80th Street","678946f4-31f4-ea11-b882-24ee9a37d45c",-73875493,40719567,"P.S./I.S. 49 - QUEENS","63-60 80th Street"
2,1,1,"b572c880-32f4-ea11-b882-24ee9a37d45c","P.S. Q016 The Nancy DeBenedittis School - Q016 - Q721 - 24Q016 - 41-15 104 STREET","b672c880-32f4-ea11-b882-24ee9a37d45c",-73860547,40748996,"P.S. 16 (OLD Q721 SPED) - QUEENS","41-15 104 STREET"
1,1,0,"1f005d7a-31f4-ea11-b882-24ee9a37d45c","P.S. 158 Bayard Taylor - M158 - M158 - 02M158 - 1458 YORK AVENUE","1d005d7a-31f4-ea11-b882-24ee9a37d45c",-73950745,40770215,"P.S. 158 - MANHATTAN","1458 YORK AVENUE"
2,1,1,"ec09e2e1-30f4-ea11-b882-24ee9a37d45c","East Williamsburg Scholars Academy - K477 - K450 - 14K477 - 850 GRAND STREET","e909e2e1-30f4-ea11-b882-24ee9a37d45c",-73938921,40711134,"GRAND STREET CAMPUS (OLD E.D.HS)- K","850 GRAND STREET"
1,0,1,"43767649-31f4-ea11-b882-24ee9a37d45c","P.S. 033 Chelsea Prep - M033 - M033 - 02M033 - 281 9 AVENUE","42767649-31f4-ea11-b882-24ee9a37d45c",-74000238,40749014,"P.S. 33 - MANHATTAN","281 9 AVENUE"
5,4,1,"286e3d68-31f4-ea11-b882-24ee9a37d45c","P.S. 333 Manhattan School for Children - M333 - M118 - 03M333 - 154 WEST 93 STREET","246e3d68-31f4-ea11-b882-24ee9a37d45c",-73971011,40791395,"I.S. 118 - MANHATTAN","154 WEST 93 STREET"
2,1,1,"d5e0838c-31f4-ea11-b882-24ee9a37d45c","Lower Manhattan Community Middle School - M896 - M282 - 02M896 - 26 BROADWAY","d1e0838c-31f4-ea11-b882-24ee9a37d45c",-74013303,40705688,"BROADWAY EDUCATION CAMPUS - M","26 BROADWAY"
1,1,0,"47a10a44-32f4-ea11-b882-24ee9a37d45c","P.S./I.S. 295 - Q295 - Q263 - 29Q295 - 222-14 JAMAICA AVENUE","41a10a44-32f4-ea11-b882-24ee9a37d45c",-73731398,40720617,"P.S. /I.S 295 - QUEENS","222-14 JAMAICA AVENUE"
3,2,1,"b7ab074a-33f4-ea11-b882-24ee9a37d45c","P.S./M.S. 194 - X194 - X194 - 11X194 - 2365 WATERBURY AVENUE","b6ab074a-33f4-ea11-b882-24ee9a37d45c",-73846594,40835410,"P.S./I.S. 194 - BRONX","2365 WATERBURY AVENUE"
2,0,2,"3aa10a44-32f4-ea11-b882-24ee9a37d45c","P.S. 254 - The Rosa Parks School - Q254 - Q254 - 27Q254 - 84-40 101 STREET","39a10a44-32f4-ea11-b882-24ee9a37d45c",-73847886,40697200,"P.S. 254 - QUEENS","84-40 101 STREET"
1,0,1,"d2883319-32f4-ea11-b882-24ee9a37d45c","Queens Transition Center - Q752 - Q142 - 75Q752 - 142-10 LINDEN BOULEVARD","2eaf0313-32f4-ea11-b882-24ee9a37d45c",-73800875,40683473,"P.S. 752 (OLD J142) - QUEENS","142-10 LINDEN BOULEVARD"
1,0,1,"377c21b7-32f4-ea11-b882-24ee9a37d45c","P.S. 004 Maurice Wollin - R004 - R004 - 31R004 - 200 NEDRA LANE","337c21b7-32f4-ea11-b882-24ee9a37d45c",-74195281,40552059,"P.S. 4 - STATEN ISLAND","200 NEDRA LANE"
1,1,0,"9969c231-32f4-ea11-b882-24ee9a37d45c","J.H.S. 202 Robert H. Goddard - Q202 - Q202 - 27Q202 - 138-30 LAFAYETTE STREET","9169c231-32f4-ea11-b882-24ee9a37d45c",-73845992,40670905,"I.S. 202 - QUEENS","138-30 LAFAYETTE STREET"
3,3,0,"35005d7a-31f4-ea11-b882-24ee9a37d45c","P.S. 166 The Richard Rodgers School of The Arts and Technology - M166 - M166 - 03M166 - 132 WEST 89 STREET","36005d7a-31f4-ea11-b882-24ee9a37d45c",-73972557,40788925,"P.S. 166 - MANHATTAN","132 WEST 89 STREET"
2,1,1,"2e9ebaee-32f4-ea11-b882-24ee9a37d45c","P.S. 291 - X291 - X015 - 10X291 - 2195 ANDREWS AVENUE","219ebaee-32f4-ea11-b882-24ee9a37d45c",-73909763,40859243,"P.S. 15 - BRONX","2195 ANDREWS AVENUE"
1,1,0,"96d91731-31f4-ea11-b882-24ee9a37d45c","Brooklyn Urban Garden Charter School - K758 - KBNU - 84K758 - 500 19 Street","97d91731-31f4-ea11-b882-24ee9a37d45c",-73982624,40656202,"STANLEY LAMM INSTITUE PRE-SCHOOL OF LONGISLAND HO","500 19 Street"
4,0,4,"83332a24-4afb-ea11-b883-24ee9a37d459","Aim High Children's Services New Life Child Dev Cn - KBGU - KBGU -  - 295 Woodbine Street","84332a24-4afb-ea11-b883-24ee9a37d459",0,0,"New Life Child Development Center 1","295 Woodbine Street"
1,1,0,"d8d10307-33f4-ea11-b882-24ee9a37d45c","Academic Leadership Charter School - X491 - X065 - 84X491 - 677 EAST 141 STREET","d9d10307-33f4-ea11-b882-24ee9a37d45c",-73912557,40807916,"P.S. 65 - BRONX","677 EAST 141 STREET"
5,4,1,"a52aa42b-33f4-ea11-b882-24ee9a37d45c","Riverdale / Kingsbridge Academy (Middle School / High School 141) - X141 - X141 - 10X141 - 660 West 237 Street","a62aa42b-33f4-ea11-b882-24ee9a37d45c",-73914141,40887407,"M.S./H.S. 141 - BRONX","660 West 237 Street"
1,1,0,"d28442ee-31f4-ea11-b882-24ee9a37d45c","P.S. 035 Nathaniel Woodhull - Q035 - Q035 - 29Q035 - 90-01 191 Street","bb8442ee-31f4-ea11-b882-24ee9a37d45c",-73768894,40713438,"P.S. 35 - QUEENS","191-02 90 Avenue"
4,3,1,"ed17b7f4-32f4-ea11-b882-24ee9a37d45c","P.S. 024 Spuyten Duyvil - X024 - X024 - 10X024 - 660 WEST 236 STREET","ee17b7f4-32f4-ea11-b882-24ee9a37d45c",-73915114,40886922,"P.S. 24 - BRONX","660 WEST 236 STREET"
1,1,0,"22eabc42-30f4-ea11-b882-24ee9a37d45c","Success Academy Charter School - Williamsburg - K182 - K050 - 84K182 - 183 SOUTH 3 STREET","1feabc42-30f4-ea11-b882-24ee9a37d45c",-73960137,40711915,"J.H.S. 50 - BROOKLYN","183 SOUTH 3 STREET"
2,0,2,"76886843-31f4-ea11-b882-24ee9a37d45c","P.S. 002 Meyer London - M002 - M002 - 02M002 - 122 Henry Street","77886843-31f4-ea11-b882-24ee9a37d45c",-73991523,40712907,"P.S. 2 - MANHATTAN","122 Henry Street"
2,1,1,"1e0410ca-32f4-ea11-b882-24ee9a37d45c","P.S. 045 John Tyler - R045 - R045 - 31R045 - 58 LAWRENCE AVENUE","1f0410ca-32f4-ea11-b882-24ee9a37d45c",-74107537,40628419,"P.S. 45 - STATEN ISLAND","58 LAWRENCE AVENUE"
1,0,1,"37a10a44-32f4-ea11-b882-24ee9a37d45c","P.S. Q256 - Q256 - Q253 - 75Q256 - 1307 CENTRAL AVENUE","30a10a44-32f4-ea11-b882-24ee9a37d45c",-73748799,40607247,"P.S. 253 -QUEENS","1307 CENTRAL AVENUE"
1,0,1,"2803cefa-32f4-ea11-b882-24ee9a37d45c","P.S. 046 Edgar Allan Poe - X046 - X046 - 10X046 - 2760 BRIGGS AVENUE","2703cefa-32f4-ea11-b882-24ee9a37d45c",-73890402,40867169,"P.S. 46 - BRONX","279 EAST 196 STREET"
1,1,0,"4c5bc58c-30f4-ea11-b882-24ee9a37d45c","P.S. 214 Michael Friedsam - K214 - K214 - 19K214 - 2944 PITKIN AVENUE","4b5bc58c-30f4-ea11-b882-24ee9a37d45c",-73862961,40675881,"P.S. 214 - BROOKLYN","2944 PITKIN AVENUE"
1,1,0,"d0fab455-31f4-ea11-b882-24ee9a37d45c","The STAR Academy - P.S.63 - M063 - M063 - 01M063 - 121 EAST 3 STREET","cefab455-31f4-ea11-b882-24ee9a37d45c",-73986214,40724440,"P.S. 63 - MANHATTAN","121 EAST 3 STREET"
3,1,2,"8b11b2e2-32f4-ea11-b882-24ee9a37d45c","Staten Island School of Civic Leadership - R861 - R861 - 31R861 - 280 REGIS DRIVE","8a11b2e2-32f4-ea11-b882-24ee9a37d45c",-74164427,40620310,"ELIZABETH A. CONNELLY CAMPUS - S.I.","280 REGIS DRIVE"
4,3,1,"9d0e6e25-32f4-ea11-b882-24ee9a37d45c","P.S./ IS 178 Holliswood - Q178 - Q178 - 26Q178 - 189-10 RADNOR ROAD","9e0e6e25-32f4-ea11-b882-24ee9a37d45c",-73777314,40724061,"P.S. 178 - QUEENS","189-10 RADNOR ROAD"
5,3,2,"5e8946f4-31f4-ea11-b882-24ee9a37d45c","P.S. 046 Alley Pond - Q046 - Q046 - 26Q046 - 64-45 218 STREET","5f8946f4-31f4-ea11-b882-24ee9a37d45c",-73758042,40745744,"P.S. 46 - QUEENS","64-45 218 STREET"
3,3,0,"0dba8b86-30f4-ea11-b882-24ee9a37d45c","P.S. 204 Vince Lombardi - K204 - K204 - 20K204 - 8101 15 AVENUE","0eba8b86-30f4-ea11-b882-24ee9a37d45c",-74006137,40613535,"P.S. 204 - BROOKLYN","8101 15 AVENUE"
1,1,0,"4febaa73-30f4-ea11-b882-24ee9a37d45c","New Bridges Elementary - K532 - K167 - 17K532 - 1025 EASTERN PARKWAY","4cebaa73-30f4-ea11-b882-24ee9a37d45c",-73934316,40669557,"P.S. 167 - BROOKLYN","1025 EASTERN PARKWAY"
1,1,0,"f01aad3c-30f4-ea11-b882-24ee9a37d45c","P.S. 031 Samuel F. Dupont - K031 - K031 - 14K031 - 75 MESEROLE AVENUE","f11aad3c-30f4-ea11-b882-24ee9a37d45c",-73954139,40726970,"P.S. 31 (OLD 126) - K","75 MESEROLE AVENUE"
2,2,0,"8d83ff9e-30f4-ea11-b882-24ee9a37d45c","P.S. 247 Brooklyn - K247 - K247 - 20K247 - 7000 21 AVENUE","8e83ff9e-30f4-ea11-b882-24ee9a37d45c",-73987195,40612247,"P.S. 247 - BROOKLYN","7000 21 AVENUE"
1,1,0,"ddfab455-31f4-ea11-b882-24ee9a37d45c","N.Y.C. Lab School for Collaborative Studies - M412 - M070 - 02M412 - 333 WEST 17 STREET","defab455-31f4-ea11-b882-24ee9a37d45c",-74002222,40742512,"I.S. 70 - MANHATTAN","333 WEST 17 STREET"
2,2,0,"a132c3fb-eaf6-ea11-b883-24ee9a37d459","P.S. 085 Judge Charles Vallone - Q085 - Q085 - 30Q085 - 23-70 31 STREET","0a7eed06-32f4-ea11-b882-24ee9a37d45c",-73915039,40773126,"P.S. 85 - QUEENS","23-70 31 STREET"
1,1,0,"9003194f-30f4-ea11-b882-24ee9a37d45c","J.H.S. 078 Roy H. Mann - K078 - K078 - 22K078 - 1420 EAST 68 STREET","8b03194f-30f4-ea11-b882-24ee9a37d45c",-73912914,40620537,"I.S. 78 - BROOKLYN","1420 EAST 68 STREET"
5,4,1,"6ca9d9c3-32f4-ea11-b882-24ee9a37d45c","I.S. 024 Myra S. Barnes - R024 - R024 - 31R024 - 750 DURANT AVENUE","5bfdc1bd-32f4-ea11-b882-24ee9a37d45c",-74145558,40545490,"I.S. 24 - STATEN ISLAND","750 DURANT AVENUE"
3,3,0,"b82ff20c-32f4-ea11-b882-24ee9a37d45c","P.S. 108 Captain Vincent G. Fowler - Q108 - Q108 - 27Q108 - 108-10 109 AVENUE","b92ff20c-32f4-ea11-b882-24ee9a37d45c",-73831025,40679083,"P.S. 108 - QUEENS","108-10 109 AVENUE"
1,0,1,"d6968d36-30f4-ea11-b882-24ee9a37d45c","Brooklyn Arbor Elementary School - K414 - K019 - 14K414 - 325 SOUTH 3 STREET","d7968d36-30f4-ea11-b882-24ee9a37d45c",-73954678,40710107,"P.S. 19 - BROOKLYN","325 SOUTH 3 STREET"
1,1,0,"348dbfcf-30f4-ea11-b882-24ee9a37d45c","P.S. 398 Walter Weaver - K398 - K398 - 17K398 - 60 EAST 94 STREET","308dbfcf-30f4-ea11-b882-24ee9a37d45c",-73927979,40663388,"P.S. 398 (UDC) - BROOKLYN","60 EAST 94 STREET"
1,1,0,"369ebaee-32f4-ea11-b882-24ee9a37d45c","P.S. 018 John Peter Zenger - X018 - X018 - 07X018 - 502 MORRIS AVENUE","379ebaee-32f4-ea11-b882-24ee9a37d45c",-73922697,40816369,"P.S. 18 - BRONX","502 MORRIS AVENUE"
1,1,0,"2c30f69f-ebf6-ea11-b883-24ee9a37d459","P.S. Q255 - Q255 - Q247 - 75Q255 - 69-10 65th Drive","2ca10a44-32f4-ea11-b882-24ee9a37d45c",-73885974,40715005,"PS/IS 128","69-10 65th Drive"
3,0,3,"102ed53d-33f4-ea11-b882-24ee9a37d45c","Bronx Early College Academy for Teaching & Learning - X324 - X166 - 09X324 - 250 EAST 164 STREET","0b2ed53d-33f4-ea11-b882-24ee9a37d45c",-73917705,40828009,"I.S. 166 - BRONX","250 EAST 164 STREET"
1,0,1,"a0dab801-ecf6-ea11-b883-24ee9a37d459","P.S. X721 - Stephen McSweeney School - X721 - X423 - 75X721 - 1551 East 172 Street","639d7c62-33f4-ea11-b882-24ee9a37d45c",-73878191,40832508,"JAMES MONROE HS CAMPUS ANNEX - BRONX","1551 East 172 Street"
2,2,0,"ca8521d0-32f4-ea11-b882-24ee9a37d45c","P.S. 060 Alice Austen - R060 - R060 - 31R060 - 55 Merrill Avenue","cb8521d0-32f4-ea11-b882-24ee9a37d45c",-74162634,40610604,"P.S. 60 - STATEN ISLAND","55 Merrill Avenue"
3,2,1,"4e767649-31f4-ea11-b882-24ee9a37d45c","P.S. 040 Augustus Saint-Gaudens - M040 - M040 - 02M040 - 320 EAST 20TH STREET","46767649-31f4-ea11-b882-24ee9a37d45c",-73981536,40735328,"P.S. 40 - MANHATTAN","320 EAST 20TH STREET"
1,0,1,"af2aa42b-33f4-ea11-b882-24ee9a37d45c","The Marie Curie School for Medicine, Nursing, and Health Professions - X237 - X143 - 10X237 - 120 WEST 231 STREET","ad2aa42b-33f4-ea11-b882-24ee9a37d45c",-73901565,40875636,"I.S. 143 - BRONX","120 WEST 231 STREET"
1,0,1,"822f77fa-31f4-ea11-b882-24ee9a37d45c","P.S. 071 Forest - Q071 - Q071 - 24Q071 - 62-85 FOREST AVENUE","802f77fa-31f4-ea11-b882-24ee9a37d45c",-73904798,40711388,"P.S. 71 - QUEENS","62-85 FOREST AVENUE"
1,1,0,"4c8dbfcf-30f4-ea11-b882-24ee9a37d45c","Midwood High School - K405 - K405 - 22K405 - 2839 BEDFORD AVENUE","4d8dbfcf-30f4-ea11-b882-24ee9a37d45c",-73952356,40632829,"MIDWOOD HS - K","2839 BEDFORD AVENUE"
1,1,0,"1c005d7a-31f4-ea11-b882-24ee9a37d45c","Yorkville East Middle School - M177 - M158 - 02M177 - 1458 YORK AVENUE","1d005d7a-31f4-ea11-b882-24ee9a37d45c",-73950745,40770215,"P.S. 158 - MANHATTAN","1458 YORK AVENUE"
1,1,0,"6b170111-6c0c-ed11-b091-088e901ef405","District 27 Pre-K Center - Q336 - Q464 - 27Q336 - 185 Beach 99th Street","6c170111-6c0c-ed11-b091-088e901ef405",-73820445,40583590,"3K CENTER @ BEACH 99TH STREET - QUEENS","185 Beach 99th Street"
1,1,0,"18f32ce2-31f4-ea11-b882-24ee9a37d45c","P.S. 019 Marino Jeantet - Q019 - Q019 - 24Q019 - 98-02 ROOSEVELT AVENUE","19f32ce2-31f4-ea11-b882-24ee9a37d45c",-73866557,40748600,"P.S. 19 - QUEENS","98-02 ROOSEVELT AVENUE"
3,3,0,"f4201dab-30f4-ea11-b882-24ee9a37d45c","I.S. 281 Joseph B Cavallaro - K281 - K281 - 21K281 - 8787 24 AVENUE","f2201dab-30f4-ea11-b882-24ee9a37d45c",-73993565,40594648,"I.S. 281 - BROOKLYN","8787 24 AVENUE"
1,1,0,"4b6e70b7-31f4-ea11-b882-24ee9a37d45c","High School for Mathematics, Science and Engineering at City College - M692 - M812 - 05M692 - 240 CONVENT AVE","4c6e70b7-31f4-ea11-b882-24ee9a37d45c",-73950354,40820208,"HS FOR MATH, SCI & ENGINEERING-M","240 CONVENT AVE"
1,0,1,"26af0313-32f4-ea11-b882-24ee9a37d45c","P.S./M.S. 138 Sunrise - Q138 - Q138 - 29Q138 - 251-11 WELLER AVENUE","1aaf0313-32f4-ea11-b882-24ee9a37d45c",-73734342,40659876,"P.S. 138 - QUEENS","251-11 WELLER AVENUE"
4,1,3,"555b4cd6-32f4-ea11-b882-24ee9a37d45c","Port Richmond High School - R445 - R445 - 31R445 - 85 ST JOSEPHS AVENUE","515b4cd6-32f4-ea11-b882-24ee9a37d45c",-74141924,40635562,"PORT RICHMOND HS - S. I.","85 ST JOSEPHS AVENUE"
2,2,0,"d0315367-30f4-ea11-b882-24ee9a37d45c","P.S. 128 Bensonhurst - K128 - K128 - 21K128 - 2075 84 STREET","d1315367-30f4-ea11-b882-24ee9a37d45c",-73995084,40604980,"P.S. 128 (TANDEM BROOKLYN STUDIO)","2075 84 STREET"
1,1,0,"08af0313-32f4-ea11-b882-24ee9a37d45c","P.S. 129 Patricia Larkin - Q129 - Q129 - 25Q129 - 128-02 7 Avenue","09af0313-32f4-ea11-b882-24ee9a37d45c",-73839505,40789926,"P.S. 129 - QUEENS","128-02 7 Avenue"
1,0,1,"ded27c6d-30f4-ea11-b882-24ee9a37d45c","P.S. 373 - Brooklyn Transition Center - K373 - K148 - 75K373 - 185 ELLERY STREET","dcd27c6d-30f4-ea11-b882-24ee9a37d45c",-73945211,40699214,"P.S. 373 (OLD P148) - BROOKLYN","185 ELLERY STREET"
1,1,0,"6cbc9674-32f4-ea11-b882-24ee9a37d45c","John Adams High School - Q480 - Q480 - 27Q480 - 101-01 ROCKAWAY BOULEVARD","6abc9674-32f4-ea11-b882-24ee9a37d45c",-73838616,40680065,"JOHN ADAMS HS - QUEENS","101-01 ROCKAWAY BOULEVARD"
1,1,0,"f9b6c337-32f4-ea11-b882-24ee9a37d45c","P.S. 213 The Carl Ullman School - Q213 - Q213 - 26Q213 - 231-02 67 AVENUE","f8b6c337-32f4-ea11-b882-24ee9a37d45c",-73745390,40747457,"P.S. 213 - QUEENS","231-02 67 AVENUE"
3,1,2,"0506003e-32f4-ea11-b882-24ee9a37d45c","P.S. 229 Emanuel Kaplan - Q229 - Q229 - 24Q229 - 67-25 51 ROAD","0106003e-32f4-ea11-b882-24ee9a37d45c",-73897108,40734682,"P.S. 229 - QUEENS","67-25 51 ROAD"
1,1,0,"858d8486-31f4-ea11-b882-24ee9a37d45c","P.S. 199 Jessie Isador Straus - M199 - M199 - 03M199 - 270 WEST 70 STREET","868d8486-31f4-ea11-b882-24ee9a37d45c",-73984423,40777603,"P.S. 199 - MANHATTAN","270 WEST 70 STREET"
1,0,1,"692b3eee-30f4-ea11-b882-24ee9a37d45c","Franklin Delano Roosevelt High School - K505 - K505 - 20K505 - 5800 20 AVENUE","682b3eee-30f4-ea11-b882-24ee9a37d45c",-73982583,40621299,"FRANKLIN D. ROOSEVELT HS - K","5800 20 AVENUE"
1,1,0,"0fa6ba98-31f4-ea11-b882-24ee9a37d45c","University Neighborhood High School - M448 - M446 - 01M448 - 200 Monroe Street","10a6ba98-31f4-ea11-b882-24ee9a37d45c",-73984128,40712269,"UNIVERSITY NEIGHBORHOOD - M","200 Monroe Street"
8,8,0,"c0fc24e8-31f4-ea11-b882-24ee9a37d45c","I.S. 025 Adrien Block - Q025 - Q025 - 25Q025 - 34-65 192 STREET","befc24e8-31f4-ea11-b882-24ee9a37d45c",-73789365,40764884,"J.H.S. 25 - QUEENS","34-65 192 STREET"
1,1,0,"f3f22ce2-31f4-ea11-b882-24ee9a37d45c","J.H.S. 008 Richard S. Grossley - Q008 - Q008 - 28Q008 - 108-35 167 STREET","f1f22ce2-31f4-ea11-b882-24ee9a37d45c",-73786403,40696910,"J.H.S. 8 - QUEENS","108-35 167 STREET"
1,1,0,"340410ca-32f4-ea11-b882-24ee9a37d45c","The Barbara Esselborn School - R053 - R053 - 31R053 - 330 DURANT AVENUE","350410ca-32f4-ea11-b882-24ee9a37d45c",-74136640,40551926,"P.S. 53 - STATEN ISLAND","330 DURANT AVENUE"
1,0,1,"eeb98b86-30f4-ea11-b882-24ee9a37d45c","P.S. 195 Manhattan Beach - K195 - K195 - 22K195 - 131 IRWIN STREET","efb98b86-30f4-ea11-b882-24ee9a37d45c",-73943498,40580161,"P.S. 195 - BROOKLYN","131 IRWIN STREET"
1,1,0,"89d810ab-31f4-ea11-b882-24ee9a37d45c","Urban Assembly School of Design and Construction, The - M300 - M535 - 02M300 - 525 WEST 50TH STREET","f137fba4-31f4-ea11-b882-24ee9a37d45c",-73992700,40765474,"PARK WEST HS (ECF) - MANHATTAN","525 WEST 50TH STREET"
4,0,4,"b9b66262-32f4-ea11-b882-24ee9a37d45c","John Bowne High School - Q425 - Q425 - 25Q425 - 63-25 MAIN STREET","bab66262-32f4-ea11-b882-24ee9a37d45c",-73823841,40737448,"JOHN BOWNE HS - QUEENS","63-25 MAIN STREET"
1,1,0,"9201ce37-33f4-ea11-b882-24ee9a37d45c","P.S. 159 Luis Munoz Marin Biling - X159 - X159 - 10X159 - 2315 WASHINGTON AVENUE","9001ce37-33f4-ea11-b882-24ee9a37d45c",-73893136,40855680,"P.S. 159 - BRONX","2315 WASHINGTON AVENUE"
1,1,0,"9553dd74-33f4-ea11-b882-24ee9a37d45c","University Heights Secondary School - X495 - X470 - 07X495 - 701 ST. ANNS AVENUE","9253dd74-33f4-ea11-b882-24ee9a37d45c",-73911633,40818041,"SOUTH BRONX EDUCATIONAL CAMPUS (OLD 38) - X","701 ST. ANNS AVENUE"
1,0,1,"81886843-31f4-ea11-b882-24ee9a37d45c","P.S. 003 Charrette School - M003 - M003 - 02M003 - 490 HUDSON STREET","82886843-31f4-ea11-b882-24ee9a37d45c",-74005949,40732603,"P.S. 3 - MANHATTAN","490 HUDSON STREET"
2,0,2,"38c73b4a-32f4-ea11-b882-24ee9a37d45c","Corona Arts & Sciences Academy - Q311 - Q311 - 24Q311 - 98-11 44TH AVENUE","36c73b4a-32f4-ea11-b882-24ee9a37d45c",-73865239,40745920,"P.S./ I.S. 311 - QUEENS","98-11 44TH AVENUE"
1,1,0,"57042f6f-ebf6-ea11-b883-24ee9a37d459","Success Academy Charter School - Harlem 1 - M351 - M620 - 84M351 - 111 EAST 33RD STREET","a0d810ab-31f4-ea11-b882-24ee9a37d45c",-73981070,40746510,"NORMAN THOMAS HS (ECF) - MANHATTAN","111 EAST 33RD STREET"
3,2,1,"347c21b7-32f4-ea11-b882-24ee9a37d45c","P.S. 003 The Margaret Gioiosa School - R003 - R003 - 31R003 - 80 SOUTH GOFF AVENUE","357c21b7-32f4-ea11-b882-24ee9a37d45c",-74211850,40520812,"P.S. 3 - STATEN ISLAND","80 SOUTH GOFF AVENUE"
1,1,0,"a183ff9e-30f4-ea11-b882-24ee9a37d45c","P.S. 253 - K253 - K253 - 21K253 - 601 OCEANVIEW AVENUE","a283ff9e-30f4-ea11-b882-24ee9a37d45c",-73961962,40580237,"P.S. 253 - BROOKLYN","601 OCEANVIEW AVENUE"
1,0,1,"c192e6d5-30f4-ea11-b882-24ee9a37d45c","Kurt Hahn Expeditionary Learning School - K569 - K415 - 18K569 - 5800 TILDEN AVENUE","5b8dbfcf-30f4-ea11-b882-24ee9a37d45c",-73922212,40647728,"SAMUEL J. TILDEN EDUCATIONAL CAMPUS - K","5800 TILDEN AVENUE"
1,1,0,"186e3d68-31f4-ea11-b882-24ee9a37d45c","P.S. 115 Alexander Humboldt - M115 - M115 - 06M115 - 586 WEST 177 STREET","166e3d68-31f4-ea11-b882-24ee9a37d45c",-73935140,40846116,"P.S. 115 - MANHATTAN","586 WEST 177 STREET"
2,2,0,"9f476368-32f4-ea11-b882-24ee9a37d45c","Flushing High School - Q460 - Q460 - 25Q460 - 35-01 UNION STREET","97476368-32f4-ea11-b882-24ee9a37d45c",-73826811,40764892,"FLUSHING HS - Q","35-01 UNION STREET"
3,3,0,"8e69c231-32f4-ea11-b882-24ee9a37d45c","P.S. 199 Maurice A. Fitzgerald - Q199 - Q199 - 24Q199 - 39-20 48 Avenue","98977d2b-32f4-ea11-b882-24ee9a37d45c",-73926081,40739831,"P.S. 199 - QUEENS","39-20 48 Avenue"
1,1,0,"c8c4bd60-4afb-ea11-b883-24ee9a37d459","Leggett Memorial - MAPW - MAVW -  - 237 EAST 104TH STREET","c9c4bd60-4afb-ea11-b883-24ee9a37d459",0,0,"LEGGETT MEMORIAL CHILD CARE CENTER","237 EAST 104TH STREET"
3,2,1,"36474313-33f4-ea11-b882-24ee9a37d45c","P.S. 094 Kings College School - X094 - X094 - 10X094 - 3530 KINGS COLLEGE PLACE","37474313-33f4-ea11-b882-24ee9a37d45c",-73875268,40880661,"P.S. 94 - BRONX","3530 KINGS COLLEGE PLACE"
2,2,0,"8407e99e-31f4-ea11-b882-24ee9a37d45c","Manhattan / Hunter Science High School - M541 - M490 - 03M541 - 122 AMSTERDAM AVENUE","7c07e99e-31f4-ea11-b882-24ee9a37d45c",-73985608,40774891,"MARTIN LUTHER KING, JR. HS - M","122 AMSTERDAM AVENUE"
1,0,1,"a2eb0e7b-33f4-ea11-b882-24ee9a37d45c","Crotona International High School - X524 - X660 - 10X524 - 2474 CROTONA AVENUE","a3eb0e7b-33f4-ea11-b882-24ee9a37d45c",-73882487,40855392,"GRACE H. DODGE VOC HS - X","2474 CROTONA AVENUE"
2,0,2,"09a198c3-30f4-ea11-b882-24ee9a37d45c","P.S. 327 Dr. Rose B. English - K327 - K327 - 23K327 - 111 BRISTOL STREET","08a198c3-30f4-ea11-b882-24ee9a37d45c",-73911788,40668232,"P.S. 327 (TANDEM K396-D75)-K","111 BRISTOL STREET"
1,0,1,"c1689025-33f4-ea11-b882-24ee9a37d45c","M.S. 129 Academy for Independent Learning and Leadership - X129 - X129 - 12X129 - 2055 MAPES AVENUE","bf689025-33f4-ea11-b882-24ee9a37d45c",-73886721,40846128,"I.S. 129 (PAIRED W P234) - BRONX","2055 MAPES AVENUE"
1,0,1,"07e2abc9-30f4-ea11-b882-24ee9a37d45c","The Science And Medicine Middle School - K366 - K366 - 18K366 - 965 EAST 107TH STREET","08e2abc9-30f4-ea11-b882-24ee9a37d45c",-73891743,40647396,"SHIRLEY CHISHOLM CAMPUS - K","965 EAST 107TH STREET"
4,4,0,"34e85c61-30f4-ea11-b882-24ee9a37d45c","P.S. 116 Elizabeth L Farrell - K116 - K116 - 32K116 - 515 KNICKERBOCKER AVENUE","35e85c61-30f4-ea11-b882-24ee9a37d45c",-73916563,40698077,"P.S. 116 - BROOKLYN","515 KNICKERBOCKER AVENUE"
1,1,0,"9d69c231-32f4-ea11-b882-24ee9a37d45c","P.S. 203 Oakland Gardens - Q203 - Q203 - 26Q203 - 53-11 SPRINGFIELD BOULEVARD","9e69c231-32f4-ea11-b882-24ee9a37d45c",-73759822,40753606,"P.S. 203 - QUEENS","53-11 SPRINGFIELD BOULEVARD"
1,0,1,"167eed06-32f4-ea11-b882-24ee9a37d45c","P.S. 088 Seneca - Q088 - Q088 - 24Q088 - 60-85 CATALPA AVENUE","177eed06-32f4-ea11-b882-24ee9a37d45c",-73896437,40704105,"P.S. 88 - QUEENS","60-85 CATALPA AVENUE"
2,1,1,"278d7953-f47b-ed11-b0c6-088e901ef405","KIDDIEPRISE 1512 LLC - KEDF - KDYW -  - 1440 86 Street","580d904e-a9ba-ec11-b8d4-24ee9a37d45c",0,0,"1440 86 STREET","1440 86 Street"
4,3,1,"ade454d6-48fb-ea11-b883-24ee9a37d459","Kiddieprise LLC - KCNH - KCNH -  - 1520 86 STREET","aee454d6-48fb-ea11-b883-24ee9a37d459",0,0,"Kiddieprise-1520 86 street","1520 86 STREET"
1,1,0,"d4e8ce00-32f4-ea11-b882-24ee9a37d45c","P.S. 076 William Hallet - Q076 - Q076 - 30Q076 - 36-36 10 Street","d2e8ce00-32f4-ea11-b882-24ee9a37d45c",-73941630,40760862,"P.S. 76 - QUEENS","36-36 10 Street"
1,1,0,"d39b4c1f-32f4-ea11-b882-24ee9a37d45c","P.S. 149 Christa McAuliffe - Q149 - Q149 - 30Q149 - 93-11 34 AVENUE","f3883319-32f4-ea11-b882-24ee9a37d45c",-73874505,40755759,"P.S. 149 - QUEENS","93-11 34 AVENUE"
1,1,0,"60b50aa5-30f4-ea11-b882-24ee9a37d45c","J.H.S. 259 William McKinley - K259 - K259 - 20K259 - 7305 Ft Hamilton Parkway","61b50aa5-30f4-ea11-b882-24ee9a37d45c",-74014633,40626089,"I.S. 259 - BROOKLYN","7305 Ft Hamilton Parkway"
1,0,1,"6e36d900-33f4-ea11-b882-24ee9a37d45c","P.S. 056 Norwood Heights - X056 - X056 - 10X056 - 341 EAST 207 STREET","6f36d900-33f4-ea11-b882-24ee9a37d45c",-73874912,40875481,"P.S. 56 - BRONX","341 EAST 207 STREET"
16,6,10,"59be7adc-32f4-ea11-b882-24ee9a37d45c","Susan E. Wagner High School - R460 - R460 - 31R460 - 1200 MANOR ROAD","5abe7adc-32f4-ea11-b882-24ee9a37d45c",-74130819,40588985,"SUSAN E. WAGNER HS - S. I.","1200 MANOR ROAD"
1,0,1,"78f4a0ef-eaf6-ea11-b883-24ee9a37d459","Sid Miller Academy - K396 - K396 - 75K396 - 110 CHESTER STREET","2d8dbfcf-30f4-ea11-b882-24ee9a37d45c",-73911788,40668232,"P.S. 396 (TANDEM K327-D23)-K","110 CHESTER STREET"
1,1,0,"8de04648-53e6-eb11-b8b1-24ee9a37d45c","Success Academy Charter School - Bronx 3 - X380 - M043 - 84X380 - 509 WEST 129 STREET","59767649-31f4-ea11-b882-24ee9a37d45c",-73955520,40815747,"I.S. 172 (OLD 43) - MANHATTAN","509 WEST 129 STREET"
9,7,2,"9f28a20c-31f4-ea11-b882-24ee9a37d45c","P.S. 163 Bath Beach - K163 - K807 - 20K163 - 109 BAY 14TH STREET","9b28a20c-31f4-ea11-b882-24ee9a37d45c",-74007469,40606739,"P.S./ I.S. 163 - BROOKLYN","109 BAY 14TH STREET"
1,0,1,"47474313-33f4-ea11-b882-24ee9a37d45c","Bronx Envision Academy - X511 - X098 - 12X511 - 1619 BOSTON ROAD","3c474313-33f4-ea11-b882-24ee9a37d45c",-73890591,40836245,"I.S. 98 - BRONX","1619 BOSTON ROAD"
1,0,1,"e7968d36-30f4-ea11-b882-24ee9a37d45c","P.S. 023 Carter G. Woodson - K023 - K023 - 14K023 - 545 WILLOUGHBY AVENUE","e5968d36-30f4-ea11-b882-24ee9a37d45c",-73947256,40694470,"P.S. 23 - BROOKLYN","545 WILLOUGHBY AVENUE"
1,0,1,"b03fce93-7c88-ec11-b8d0-24ee9a37d45c","Academy of American Studies - Q575 - Q575 - 30Q575 - 40-11 28th Street","b13fce93-7c88-ec11-b8d0-24ee9a37d45c",-73936596,40751839,"ACADEMY OF AMERICAN STUDIES - QUEENS","40-11 28th Street"
3,2,1,"2bb4977a-32f4-ea11-b882-24ee9a37d45c","Queens High School of Teaching, Liberal Arts and the Sciences - Q566 - Q566 - 26Q566 - 74-20 COMMONWEALTH BLVD","27b4977a-32f4-ea11-b882-24ee9a37d45c",-73728834,40744197,"QNS HS OF TEACH., LIB. ARTS&SCI-Q","74-20 COMMONWEALTH BLVD"
2,2,0,"0ff32ce2-31f4-ea11-b882-24ee9a37d45c","P.S. 017 Henry David Thoreau - Q017 - Q017 - 30Q017 - 28-37 29 STREET","0af32ce2-31f4-ea11-b882-24ee9a37d45c",-73922544,40768034,"P.S. 17 - QUEENS","28-37 29 STREET"
2,0,2,"84a9d9c3-32f4-ea11-b882-24ee9a37d45c","P.S. 032 The Gifford School - R032 - R032 - 31R032 - 232 Barlow Avenue","80a9d9c3-32f4-ea11-b882-24ee9a37d45c",-74155400,40557900,"P.S. 32 - STATEN ISLAND","232 Barlow Avenue"
1,0,1,"552f7d06-31f4-ea11-b882-24ee9a37d45c","P.S. 112 Lefferts Park - K112 - K768 - 20K112 - 7301 15th Avenue","562f7d06-31f4-ea11-b882-24ee9a37d45c",-74001900,40618726,"P.S. 768 - BROOKLYN","7301 15th Avenue"
1,0,1,"c392e6d5-30f4-ea11-b882-24ee9a37d45c","Cultural Academy for the Arts and Sciences - K629 - K415 - 18K629 - 5800 TILDEN AVENUE","5b8dbfcf-30f4-ea11-b882-24ee9a37d45c",-73922212,40647728,"SAMUEL J. TILDEN EDUCATIONAL CAMPUS - K","5800 TILDEN AVENUE"
1,0,1,"4d3cbf01-ebf6-ea11-b883-24ee9a37d459","P.S. R373 - R373 - R040 - 75R373 - 91 HENDERSON AVENUE","97a9d9c3-32f4-ea11-b882-24ee9a37d45c",-74095454,40641180,"P.S. 373 (OLD P40) - STATEN ISLAND","91 HENDERSON AVENUE"
2,2,0,"c98442ee-31f4-ea11-b882-24ee9a37d45c","P.S. 032 State Street - Q032 - Q032 - 25Q032 - 171-11 35 AVENUE","ca8442ee-31f4-ea11-b882-24ee9a37d45c",-73794323,40765459,"P.S. 32 - QUEENS","171-11 35 AVENUE"
5,4,1,"f08a0044-33f4-ea11-b882-24ee9a37d45c","P.S. 182 - X182 - X182 - 08X182 - 601 STICKBALL BOULEVARD","f18a0044-33f4-ea11-b882-24ee9a37d45c",-73856976,40818925,"P.S. 182 - BRONX","601 STICKBALL BOULEVARD"
1,1,0,"1606003e-32f4-ea11-b882-24ee9a37d45c","P.S. 234 - Q234 - Q234 - 30Q234 - 30-15 29 STREET","1506003e-32f4-ea11-b882-24ee9a37d45c",-73923044,40766898,"P.S. 234 - QUEENS","30-14 30 STREET"
2,2,0,"8803194f-30f4-ea11-b882-24ee9a37d45c","Brooklyn Environmental Exploration School (BEES) - K664 - K073 - 23K664 - 251 MAC DOUGAL STREET","8503194f-30f4-ea11-b882-24ee9a37d45c",-73910719,40680679,"P.S. 73 - BROOKLYN","251 MAC DOUGAL STREET"
2,0,2,"62be7adc-32f4-ea11-b882-24ee9a37d45c","Ralph R. McKee Career and Technical Education High School - R600 - R600 - 31R600 - 101 Belmont Place","5ebe7adc-32f4-ea11-b882-24ee9a37d45c",-74079263,40642820,"RALPH MCKEE VOC HS - S. I.","101 Belmont Place"
1,1,0,"bc689025-33f4-ea11-b882-24ee9a37d45c","Linden Tree Elementary School - X567 - X127 - 11X567 - 1560 PURDY STREET","b9689025-33f4-ea11-b882-24ee9a37d45c",-73853203,40838759,"I.S. 127 - BRONX","1560 PURDY STREET"
1,0,1,"25e0d393-ebf6-ea11-b883-24ee9a37d459","P.S. Q993 - Q993 - Q130 - 75Q993 - 200-01 42 AVENUE","04af0313-32f4-ea11-b882-24ee9a37d45c",-73784009,40760219,"P.S. 130 - QUEENS","200-01 42 AVENUE"
1,1,0,"367eed06-32f4-ea11-b882-24ee9a37d45c","P.S. 099 Kew Gardens - Q099 - Q099 - 28Q099 - 82-37 KEW GARDENS ROAD","377eed06-32f4-ea11-b882-24ee9a37d45c",-73827722,40711502,"P.S. 99 - QUEENS","82-37 KEW GARDENS ROAD"
1,0,1,"449f4974-31f4-ea11-b882-24ee9a37d45c","Future Leaders Institute Charter School - M861 - M144 - 84M861 - 134 WEST 122 STREET","459f4974-31f4-ea11-b882-24ee9a37d45c",-73948385,40806055,"P.S. 242 (OLD P144) - MANHATTAN","134 WEST 122 STREET"
1,1,0,"8603194f-30f4-ea11-b882-24ee9a37d45c","Brooklyn Landmark Elementary School - K599 - K073 - 23K599 - 251 MAC DOUGAL STREET","8503194f-30f4-ea11-b882-24ee9a37d45c",-73910719,40680679,"P.S. 73 - BROOKLYN","251 MAC DOUGAL STREET"
5,3,2,"18474313-33f4-ea11-b882-24ee9a37d45c","P.S. 086 Kingsbridge Heights - X086 - X086 - 10X086 - 2756 RESERVOIR AVENUE","19474313-33f4-ea11-b882-24ee9a37d45c",-73897066,40869061,"P.S. 86 - BRONX","2756 RESERVOIR AVENUE"
1,1,0,"0a9c4c1f-32f4-ea11-b882-24ee9a37d45c","P.S. 165 Edith K. Bergtraum - Q165 - Q165 - 25Q165 - 70-35 150 Street","0b9c4c1f-32f4-ea11-b882-24ee9a37d45c",-73816966,40729746,"P.S. 165 - QUEENS","70-35 150 Street"
1,0,1,"40b4977a-32f4-ea11-b882-24ee9a37d45c","Queens Technical High School - Q600 - Q600 - 24Q600 - 37-02 47 AVENUE","41b4977a-32f4-ea11-b882-24ee9a37d45c",-73927995,40741658,"QUEENS VOC HS - Q","37-02 47 AVENUE"
1,1,0,"409f4974-31f4-ea11-b882-24ee9a37d45c","J.H.S. 143 Eleanor Roosevelt - M143 - M143 - 06M143 - 511 WEST 182ND STREET","3f9f4974-31f4-ea11-b882-24ee9a37d45c",-73930991,40849311,"I.S. 143 - MANHATTAN","511 WEST 182ND STREET"
1,1,0,"e292e6d5-30f4-ea11-b882-24ee9a37d45c","James Madison High School - K425 - K425 - 22K425 - 3787 BEDFORD AVENUE","e092e6d5-30f4-ea11-b882-24ee9a37d45c",-73947661,40610499,"JAMES MADISON HS - K","3787 BEDFORD AVENUE"
1,1,0,"bd0d3c5b-30f4-ea11-b882-24ee9a37d45c","P.S. 094 The Henry Longfellow - K094 - K094 - 15K094 - 5010 6 AVENUE","8fd92255-30f4-ea11-b882-24ee9a37d45c",-74008795,40643730,"P.S. 94 - BROOKLYN","5010 6 AVENUE"
2,1,1,"3de4d766-4afb-ea11-b883-24ee9a37d459","ECHO PARK EARLY CHILDHOOD CENTER - MAWM - MAWM -  - 1841 PARK AVENUE","3ee4d766-4afb-ea11-b883-24ee9a37d459",0,0,"ECHO PARK EARLY CHILDHOOD CENTER","1841 PARK AVENUE"
1,0,1,"4c2b3eee-30f4-ea11-b882-24ee9a37d45c","District 20 Pre-K Center - K768 - K491 - 20K768 - 2165 71st Street","4d2b3eee-30f4-ea11-b882-24ee9a37d45c",-73985835,40610983,"PRE-K CENTER @ 2165 71ST STREET - BROOKLYN","2165 71st Street"
1,1,0,"da9b4c1f-32f4-ea11-b882-24ee9a37d45c","P.S. 151 Mary D. Carter - Q151 - Q151 - 30Q151 - 50-05 31 AVENUE","db9b4c1f-32f4-ea11-b882-24ee9a37d45c",-73908146,40758027,"P.S. 151 - QUEENS","50-05 31 AVENUE"
1,1,0,"fa1aad3c-30f4-ea11-b882-24ee9a37d45c","P.S. 034 Oliver H. Perry - K034 - K034 - 14K034 - 131 NORMAN AVENUE","f91aad3c-30f4-ea11-b882-24ee9a37d45c",-73949756,40726378,"P.S. 34 - BROOKLYN","131 NORMAN AVENUE"
1,1,0,"cee0838c-31f4-ea11-b882-24ee9a37d45c","The River School - M281 - M281 - 02M281 - 425 East 35 Street","cde0838c-31f4-ea11-b882-24ee9a37d45c",-73972592,40744288,"P.S. 281 - MANHATTAN","425 East 35 Street"
1,1,0,"74a9d9c3-32f4-ea11-b882-24ee9a37d45c","P.S. 026 The Carteret School - R026 - R026 - 31R026 - 4108 VICTORY BOULEVARD","75a9d9c3-32f4-ea11-b882-24ee9a37d45c",-74190093,40591546,"P.S. 26 - STATEN ISLAND","4108 VICTORY BOULEVARD"
3,2,1,"bbbfa431-33f4-ea11-b882-24ee9a37d45c","The Laboratory School of Finance and Technology: X223 - X223 - X149 - 07X223 - 360 EAST 145 STREET","bcbfa431-33f4-ea11-b882-24ee9a37d45c",-73920851,40813612,"J.H.S. 149 - BRONX","360 EAST 145 STREET"
1,1,0,"1878931f-33f4-ea11-b882-24ee9a37d45c","P.S. 310 Marble Hill - X310 - X122 - 10X310 - 260 W KINGSBRIDGE RD","1978931f-33f4-ea11-b882-24ee9a37d45c",-73905547,40872477,"P.S. 310 - BRONX","260 W KINGSBRIDGE RD"
1,1,0,"72283fb1-30f4-ea11-b882-24ee9a37d45c","Community Roots Charter School - K536 - K287 - 84K536 - 50 NAVY STREET","73283fb1-30f4-ea11-b882-24ee9a37d45c",-73981120,40697856,"P.S. 287 - BROOKLYN","50 NAVY STREET"
7,2,5,"d22ff20c-32f4-ea11-b882-24ee9a37d45c","P.S. 117 J. Keld / Briarwood School - Q117 - Q117 - 28Q117 - 85-15 143 STREET","d32ff20c-32f4-ea11-b882-24ee9a37d45c",-73812968,40710428,"P.S. 117 - QUEENS","85-15 143 STREET"
1,0,1,"bab36d80-30f4-ea11-b882-24ee9a37d45c","The SEEALL Academy - K180 - K180 - 20K180 - 5601 16 AVENUE","b8b36d80-30f4-ea11-b882-24ee9a37d45c",-73989250,40626454,"P.S. 180 - BROOKLYN","5601 16 AVENUE"
1,1,0,"659d7c62-33f4-ea11-b882-24ee9a37d45c","Mott Hall V - X242 - X423 - 12X242 - 1551 East 172 Street","639d7c62-33f4-ea11-b882-24ee9a37d45c",-73878191,40832508,"JAMES MONROE HS CAMPUS ANNEX - BRONX","1551 East 172 Street"
1,1,0,"e4b36d80-30f4-ea11-b882-24ee9a37d45c","P.S. 192 - The Magnet School for Math and Science Inquiry - K192 - K192 - 20K192 - 4715 18 AVENUE","e5b36d80-30f4-ea11-b882-24ee9a37d45c",-73979540,40628800,"P.S. 192 - BROOKLYN","4715 18 AVENUE"
1,0,1,"58507380-31f4-ea11-b882-24ee9a37d45c","P.S./I.S. 187 Hudson Cliffs - M187 - M187 - 06M187 - 349 CABRINI BOULEVARD","59507380-31f4-ea11-b882-24ee9a37d45c",-73936840,40856239,"P.S./I.S. 187 - MANHATTAN","349 CABRINI BOULEVARD"
3,3,0,"95886843-31f4-ea11-b882-24ee9a37d45c","P.S. 009 Sarah Anderson - M009 - M009 - 03M009 - 100 WEST 84 STREET","87886843-31f4-ea11-b882-24ee9a37d45c",-73974256,40785234,"P.S. 9 - MANHATTAN","100 WEST 84 STREET"
2,2,0,"38005d7a-31f4-ea11-b882-24ee9a37d45c","J.H.S. 167 Robert F. Wagner - M167 - M167 - 02M167 - 220 EAST 76 STREET","39005d7a-31f4-ea11-b882-24ee9a37d45c",-73957827,40771541,"I.S. 167 - MANHATTAN","220 EAST 76 STREET"
1,1,0,"b3fc24e8-31f4-ea11-b882-24ee9a37d45c","P.S. 022 Thomas Jefferson - Q022 - Q022 - 25Q022 - 153-33 SANFORD AVENUE","b1fc24e8-31f4-ea11-b882-24ee9a37d45c",-73811373,40761744,"P.S. 22 - QUEENS","153-33 SANFORD AVENUE"
1,0,1,"0020c663-6a0c-ed11-b091-088e901ef405","P.S. K771 - K771 - K203 - 75K771 - 5101 AVENUE M","0bba8b86-30f4-ea11-b882-24ee9a37d45c",-73925732,40622108,"P.S. 203 - BROOKLYN","5101 AVENUE M"
1,0,1,"d6454b50-32f4-ea11-b882-24ee9a37d45c","The Children's Lab School - Q343 - Q313 - 24Q343 - 45-45 42ND STREET","d7454b50-32f4-ea11-b882-24ee9a37d45c",-73922604,40742580,"THE WALTER MCCAFFREY CAMPUS - QUEENS","45-45 42ND STREET"
1,1,0,"538dbfcf-30f4-ea11-b882-24ee9a37d45c","Abraham Lincoln High School - K410 - K410 - 21K410 - 2800 OCEAN PARKWAY","518dbfcf-30f4-ea11-b882-24ee9a37d45c",-73968733,40582627,"ABRAHAM LINCOLN HS - K","2800 OCEAN PARKWAY"
1,1,0,"aafc24e8-31f4-ea11-b882-24ee9a37d45c","P.S. 020 John Bowne - Q020 - Q020 - 25Q020 - 142-30 BARCLAY AVENUE","14f32ce2-31f4-ea11-b882-24ee9a37d45c",-73824388,40758347,"P.S. 20 - QUEENS","142-30 BARCLAY AVENUE"
1,1,0,"f78052e9-ebf6-ea11-b883-24ee9a37d459","KIPP Freedom Charter School - X598 - X044 - 84X598 - 1825 PROSPECT AVENUE","1d03cefa-32f4-ea11-b882-24ee9a37d45c",-73891086,40842564,"P.S. 44 - BRONX","1825 PROSPECT AVENUE"
1,0,1,"9072c880-32f4-ea11-b882-24ee9a37d45c","Eagle Academy for Young Men III - Q327 - Q633 - 29Q327 - 171-10 Linden Boulevard","9172c880-32f4-ea11-b882-24ee9a37d45c",-73778924,40691720,"EAGLE ACADEMY - QUEENS","171-10 Linden Boulevard"
5,4,1,"63ffcc6e-33f4-ea11-b882-24ee9a37d45c","The Bronx High School of Science - X445 - X445 - 10X445 - 75 WEST 205 STREET","64ffcc6e-33f4-ea11-b882-24ee9a37d45c",-73889011,40879958,"BRONX HS OF SCIENCE - X","75 WEST 205 STREET"
1,1,0,"ef9b4c1f-32f4-ea11-b882-24ee9a37d45c","J.H.S. 157 Stephen A. Halsey - Q157 - Q157 - 28Q157 - 63-55 102ND STREET","f09b4c1f-32f4-ea11-b882-24ee9a37d45c",-73852879,40732348,"J.H.S. 157 - QUEENS","63-55 102ND STREET"
1,1,0,"ddaeb707-ecf6-ea11-b883-24ee9a37d459","LYFE - M984 - X470 - 79M984 - 701 ST. ANNS AVENUE","9253dd74-33f4-ea11-b882-24ee9a37d45c",-73911633,40818041,"SOUTH BRONX EDUCATIONAL CAMPUS (OLD 38) - X","701 ST. ANNS AVENUE"
1,0,1,"47ebaa73-30f4-ea11-b882-24ee9a37d45c","Achievement First Linden Charter School - K788 - K166 - 84K788 - 800 VAN SICLEN AVE","41ebaa73-30f4-ea11-b882-24ee9a37d45c",-73885704,40659934,"I.S. 166 - BROOKLYN","800 VAN SICLEN AVE"
1,1,0,"37a6ba98-31f4-ea11-b882-24ee9a37d45c","Innovation Diploma Plus - M404 - M470 - 03M404 - 145 WEST 84 STREET","33a6ba98-31f4-ea11-b882-24ee9a37d45c",-73974483,40786134,"LOUIS D. BRANDEIS HS - MANHATTAN","145 WEST 84 STREET"
3,0,3,"89886843-31f4-ea11-b882-24ee9a37d45c","P.S. 005 Ellen Lurie - M005 - M005 - 06M005 - 3703 TENTH AVENUE","8a886843-31f4-ea11-b882-24ee9a37d45c",0,0,"P.S. 5 - MANHATTAN","3703 TENTH AVENUE"
2,2,0,"a40e6e25-32f4-ea11-b882-24ee9a37d45c","Scholars' Academy - Q323 - Q180 - 27Q323 - 320 BEACH 104TH STREET","a50e6e25-32f4-ea11-b882-24ee9a37d45c",-73825162,40584543,"I.S. 323 (OLD IS 180) - QUEENS","320 BEACH 104TH STREET"
1,1,0,"6934aa92-31f4-ea11-b882-24ee9a37d45c","Success Academy Charter School - Washington Heights - M265 - M387 - 84M265 - 701 Fort Washington Avenue","6a34aa92-31f4-ea11-b882-24ee9a37d45c",-73935231,40857650,"Success Academy - Washington Heights","701 Fort Washington Avenue"
3,2,1,"458dbfcf-30f4-ea11-b882-24ee9a37d45c","Leaders High School - K572 - K400 - 21K572 - 2630 BENSON AVENUE","3a8dbfcf-30f4-ea11-b882-24ee9a37d45c",-73986313,40593028,"Lafayette Educational Campus","2630 BENSON AVENUE"
1,0,1,"5ede5eb7-30f4-ea11-b882-24ee9a37d45c","P.S. 307 Daniel Hale Williams - K307 - K307 - 13K307 - 209 YORK STREET","5fde5eb7-30f4-ea11-b882-24ee9a37d45c",-73981599,40701789,"P.S. 307 - BROOKLYN","209 YORK STREET"
2,2,0,"cc2ff20c-32f4-ea11-b882-24ee9a37d45c","The James J. Ambrose School - Q115 - Q115 - 26Q115 - 80-51 261 STREET","cd2ff20c-32f4-ea11-b882-24ee9a37d45c",-73709404,40744201,"The James J. Ambrose School","80-51 261 STREET"
1,0,1,"5ade5eb7-30f4-ea11-b882-24ee9a37d45c","P.S. 306 Ethan Allen - K306 - K306 - 19K306 - 970 VERMONT STREET","59de5eb7-30f4-ea11-b882-24ee9a37d45c",-73886620,40655340,"P.S. 306 - BROOKLYN","970 VERMONT STREET"
1,1,0,"39e85c61-30f4-ea11-b882-24ee9a37d45c","Brooklyn High School for Leadership and Community Service - K616 - K117 - 13K616 - 300 WILLOUGHBY AVENUE","33e85c61-30f4-ea11-b882-24ee9a37d45c",-73958180,40692015,"I.S. 117 - BROOKLYN","300 WILLOUGHBY AVENUE"
3,2,1,"8c72c880-32f4-ea11-b882-24ee9a37d45c","Thomas A. Edison Career and Technical Education High School - Q620 - Q620 - 28Q620 - 165-65 84 AVENUE","49b4977a-32f4-ea11-b882-24ee9a37d45c",-73799692,40716071,"THOMAS A. EDISON VOC HS - Q","165-65 84 AVENUE"
1,1,0,"4f36d900-33f4-ea11-b882-24ee9a37d45c","P.S. 047 John Randolph - X047 - X047 - 12X047 - 1794 EAST 172 STREET","5036d900-33f4-ea11-b882-24ee9a37d45c",-73866974,40832529,"P.S. 47 - BRONX","1794 EAST 172 STREET"
1,1,0,"880e6e25-32f4-ea11-b882-24ee9a37d45c","P.S. 171 Peter G. Van Alst - Q171 - Q171 - 30Q171 - 14-14 29 AVENUE","870e6e25-32f4-ea11-b882-24ee9a37d45c",-73929093,40770926,"P.S. 171 - QUEENS","14-14 29 AVENUE"
1,0,1,"64bc9674-32f4-ea11-b882-24ee9a37d45c","Richmond Hill High School - Q475 - Q475 - 27Q475 - 89-30 114 Street","3002926e-32f4-ea11-b882-24ee9a37d45c",-73833815,40695171,"RICHMOND HILL HS - Q","89-30 114 Street"
1,0,1,"912aa42b-33f4-ea11-b882-24ee9a37d45c","The Angelo Patri Middle School - X391 - X137 - 10X391 - 2225 WEBSTER AVENUE","8e2aa42b-33f4-ea11-b882-24ee9a37d45c",-73897404,40854257,"I.S. 391 (UDC) - BRONX","2225 WEBSTER AVENUE"
1,0,1,"e2ce496e-31f4-ea11-b882-24ee9a37d45c","Success Academy Charter School - Harlem 5 - M482 - M123 - 84M482 - 301 WEST 140 STREET","e3ce496e-31f4-ea11-b882-24ee9a37d45c",-73944551,40820216,"P.S. 123 - MANHATTAN","301 WEST 140 STREET"
1,1,0,"47fdc1bd-32f4-ea11-b882-24ee9a37d45c","P.S. 8 Shirlee Solomon - R008 - R008 - 31R008 - 112 LINDENWOOD ROAD","48fdc1bd-32f4-ea11-b882-24ee9a37d45c",-74152212,40547567,"P.S. 8 - STATEN ISLAND","112 LINDENWOOD ROAD"
1,0,1,"139ebaee-32f4-ea11-b882-24ee9a37d45c","P.S. 006 West Farms - X006 - X006 - 12X006 - 1000 EAST TREMONT AVENUE","0e9ebaee-32f4-ea11-b882-24ee9a37d45c",-73882531,40840445,"P.S. 6 - BRONX","1000 EAST TREMONT AVENUE"
1,1,0,"778d8486-31f4-ea11-b882-24ee9a37d45c","KIPP Infinity Charter School - M336 - M195 - 84M336 - 625 WEST 133 STREET","758d8486-31f4-ea11-b882-24ee9a37d45c",-73956814,40819793,"TERENCE D. TOLBERT EDUCATION COMPLEX - MANHATTAN","625 WEST 133 STREET"
1,1,0,"24e2abc9-30f4-ea11-b882-24ee9a37d45c","KIPP Always Mentally Prepared Charter School - K357 - K390 - 84K357 - 1224 PARK PLACE","25e2abc9-30f4-ea11-b882-24ee9a37d45c",-73937601,40672290,"I.S. 390 - BROOKLYN","1224 PARK PLACE"
1,1,0,"bbba3c50-33f4-ea11-b882-24ee9a37d45c","Comprehensive Model School Project M.S. 327 - X327 - X240 - 09X327 - 1501 JEROME AVENUE","baba3c50-33f4-ea11-b882-24ee9a37d45c",-73916084,40842503,"DOE NEW SETTLEMENT COMMUNITY CAMPUS - X","1501 JEROME AVENUE"
1,1,0,"8a41e65b-31f4-ea11-b882-24ee9a37d45c","P.S. 084 Lillian Weber - M084 - M084 - 03M084 - 32 West 92 Street","8b41e65b-31f4-ea11-b882-24ee9a37d45c",-73968419,40789479,"P.S. 84 - MANHATTAN","32 West 92 Street"
1,1,0,"fd8a0044-33f4-ea11-b882-24ee9a37d45c","Jill Chaifetz Transfer High School - X379 - X184 - 07X379 - 778 FOREST AVENUE","f88a0044-33f4-ea11-b882-24ee9a37d45c",-73905389,40818703,"I.S. 184 - BRONX","778 FOREST AVENUE"
1,0,1,"28a6ba98-31f4-ea11-b882-24ee9a37d45c","The College Academy - M462 - M465 - 06M462 - 549 AUDUBON AVENUE","25a6ba98-31f4-ea11-b882-24ee9a37d45c",-73926060,40856532,"G. WASHINGTON HS EDUC. CAMPUS - M","549 AUDUBON AVENUE"
2,2,0,"d479df48-30f4-ea11-b882-24ee9a37d45c","Community Roots Charter School - K536 - K067 - 84K536 - 51 SAINT EDWARDS STREET","d179df48-30f4-ea11-b882-24ee9a37d45c",-73977674,40695339,"P.S. 67 - BROOKLYN","51 SAINT EDWARDS STREET"
1,1,0,"1ee2abc9-30f4-ea11-b882-24ee9a37d45c","J.H.S. 383 Philippa Schuyler - K383 - K383 - 32K383 - 1300 GREENE AVENUE","1de2abc9-30f4-ea11-b882-24ee9a37d45c",-73919088,40697898,"I.S. 383 - BROOKLYN","1300 GREENE AVENUE"
2,2,0,"0d0410ca-32f4-ea11-b882-24ee9a37d45c","The Stephanie A. Vierno School - R041 - R041 - 31R041 - 216 CLAWSON STREET","0e0410ca-32f4-ea11-b882-24ee9a37d45c",-74108492,40573599,"P.S. 41 - STATEN ISLAND","216 CLAWSON STREET"
2,2,0,"430410ca-32f4-ea11-b882-24ee9a37d45c","Space Shuttle Columbia School - R058 - R058 - 31R058 - 77 MARSH AVENUE","2a0410ca-32f4-ea11-b882-24ee9a37d45c",-74160867,40582791,"P.S. 58 - STATEN ISLAND","77 MARSH AVENUE"
1,1,0,"692f77fa-31f4-ea11-b882-24ee9a37d45c","P.S. 063 Old South - Q063 - Q063 - 27Q063 - 90-15 SUTTER AVENUE","6a2f77fa-31f4-ea11-b882-24ee9a37d45c",-73846796,40676978,"P.S. 63 - QUEENS","90-15 SUTTER AVENUE"
1,1,0,"72d92255-30f4-ea11-b882-24ee9a37d45c","P.S. 086 The Irvington - K086 - K086 - 32K086 - 220 IRVING AVENUE","71d92255-30f4-ea11-b882-24ee9a37d45c",-73917804,40700595,"P.S. 86 - BROOKLYN","220 IRVING AVENUE"
