"TotalCases","StudentCases","EmployeeCases","nycsr_locationsiteid","nycsr_sitename","nycsr_building.nycsr_buildingid","nycsr_building.nycsr_longitude","nycsr_building.nycsr_latitude","nycsr_building.nycsr_buildingname","nycsr_building.nycsr_address"
2,1,1,"1ee2abc9-30f4-ea11-b882-24ee9a37d45c","J.H.S. 383 Philippa Schuyler - K383 - K383 - 32K383 - 1300 GREENE AVENUE","1de2abc9-30f4-ea11-b882-24ee9a37d45c",-73919088,40697898,"I.S. 383 - BROOKLYN","1300 GREENE AVENUE"
2,1,1,"9369c231-32f4-ea11-b882-24ee9a37d45c","P.S./M.S. 200 - The Magnet School of Global Studies and Leadership - Q200 - Q200 - 25Q200 - 70-10 164 STREET","9469c231-32f4-ea11-b882-24ee9a37d45c",-73805759,40731070,"P.S. 200 - QUEENS","70-10 164 STREET"
8,6,2,"60b50aa5-30f4-ea11-b882-24ee9a37d45c","J.H.S. 259 William McKinley - K259 - K259 - 20K259 - 7305 Ft Hamilton Parkway","61b50aa5-30f4-ea11-b882-24ee9a37d45c",-74014633,40626089,"I.S. 259 - BROOKLYN","7305 Ft Hamilton Parkway"
2,1,1,"1a9ebaee-32f4-ea11-b882-24ee9a37d45c","P.S. 008 Isaac Varian - X008 - X008 - 10X008 - 3010 BRIGGS AVENUE","1b9ebaee-32f4-ea11-b882-24ee9a37d45c",-73883339,40872259,"P.S. 8 - BRONX","3010 BRIGGS AVENUE"
2,2,0,"1206003e-32f4-ea11-b882-24ee9a37d45c","P.S. 232 Lindenwood - Q232 - Q232 - 27Q232 - 153-23 83 STREET","1106003e-32f4-ea11-b882-24ee9a37d45c",-73850622,40665408,"P.S. 232 - QUEENS","153-23 83 STREET"
1,0,1,"139ebaee-32f4-ea11-b882-24ee9a37d45c","P.S. 006 West Farms - X006 - X006 - 12X006 - 1000 EAST TREMONT AVENUE","0e9ebaee-32f4-ea11-b882-24ee9a37d45c",-73882531,40840445,"P.S. 6 - BRONX","1000 EAST TREMONT AVENUE"
2,2,0,"6c41e65b-31f4-ea11-b882-24ee9a37d45c","The Lexington Academy - M072 - M072 - 04M072 - 131 EAST 104 STREET","6d41e65b-31f4-ea11-b882-24ee9a37d45c",-73947450,40791444,"P.S. 72 - MANHATTAN","131 EAST 104 STREET"
1,1,0,"12cf496e-31f4-ea11-b882-24ee9a37d45c","Dos Puentes Elementary School - M103 - M132 - 06M103 - 185 WADSWORTH AVENUE","10cf496e-31f4-ea11-b882-24ee9a37d45c",-73933964,40850561,"P.S. 132 - MANHATTAN","185 WADSWORTH AVENUE"
1,0,1,"0678931f-33f4-ea11-b882-24ee9a37d45c","I.S. 117 Joseph H. Wade - X117 - X117 - 09X117 - 1865 MORRIS AVENUE","0578931f-33f4-ea11-b882-24ee9a37d45c",-73909022,40848552,"I.S. 117 - BRONX","1865 MORRIS AVENUE"
1,0,1,"8fe657bd-30f4-ea11-b882-24ee9a37d45c","P.S. 503: The School of Discovery - K503 - K314 - 20K503 - 330 59 Street","8ee657bd-30f4-ea11-b882-24ee9a37d45c",-74019299,40641950,"P.S. 314 - BROOKLYN","330 59 Street"
5,1,4,"d82ff20c-32f4-ea11-b882-24ee9a37d45c","P.S./I.S. 119 The Glendale - Q119 - Q119 - 24Q119 - 74-01 78 AVENUE","d92ff20c-32f4-ea11-b882-24ee9a37d45c",-73875073,40705187,"I.S. 119 - QUEENS","74-01 78 AVENUE"
8,3,5,"a183ff9e-30f4-ea11-b882-24ee9a37d45c","P.S. 253 - K253 - K253 - 21K253 - 601 OCEANVIEW AVENUE","a283ff9e-30f4-ea11-b882-24ee9a37d45c",-73961962,40580237,"P.S. 253 - BROOKLYN","601 OCEANVIEW AVENUE"
1,0,1,"b548b1f5-eaf6-ea11-b883-24ee9a37d459","District 2 Pre-K Center - M391 - M391 - 02M391 - 2-26 WASHINGTON STREET","7034aa92-31f4-ea11-b882-24ee9a37d45c",-74015929,40704892,"PRE-K @ 2-26 WASHINGTON ST - MANHATTAN","2-26 WASHINGTON STREET"
4,2,2,"d1d27c6d-30f4-ea11-b882-24ee9a37d45c","The Brooklyn New School, P.S. 146 - K146 - K142 - 15K146 - 610 HENRY STREET","cfd27c6d-30f4-ea11-b882-24ee9a37d45c",-74002022,40679462,"J.H.S. 142 - BROOKLYN","610 HENRY STREET"
2,0,2,"b5b36d80-30f4-ea11-b882-24ee9a37d45c","P.S. 179 Kensington - K179 - K179 - 20K179 - 202 AVENUE C","13d1de79-30f4-ea11-b882-24ee9a37d45c",-73977260,40640127,"P.S. 179 - BROOKLYN","202 AVENUE C"
2,0,2,"10b7c337-32f4-ea11-b882-24ee9a37d45c","P.S. 221 The North Hills School - Q221 - Q221 - 26Q221 - 57-40 MARATHON PARKWAY","11b7c337-32f4-ea11-b882-24ee9a37d45c",-73731518,40758808,"P.S. 221 - QUEENS","57-40 MARATHON PARKWAY"
1,0,1,"ac2aa42b-33f4-ea11-b882-24ee9a37d45c","The New School for Leadership and Journalism - X244 - X143 - 10X244 - 120 WEST 231 STREET","ad2aa42b-33f4-ea11-b882-24ee9a37d45c",-73901565,40875636,"I.S. 143 - BRONX","120 WEST 231 STREET"
3,0,3,"538dbfcf-30f4-ea11-b882-24ee9a37d45c","Abraham Lincoln High School - K410 - K410 - 21K410 - 2800 OCEAN PARKWAY","518dbfcf-30f4-ea11-b882-24ee9a37d45c",-73968733,40582627,"ABRAHAM LINCOLN HS - K","2800 OCEAN PARKWAY"
1,0,1,"e4e0838c-31f4-ea11-b882-24ee9a37d45c","Sixth Avenue Elementary School - M340 - M340 - 02M340 - 64 WEST 17 STREET","e3e0838c-31f4-ea11-b882-24ee9a37d45c",-73995534,40739145,"THE SIXTH AVENUE EDUCATIONAL CAMPUS - MANHATTAN","64 WEST 17 STREET"
2,1,1,"89283fb1-30f4-ea11-b882-24ee9a37d45c","Achievement First Brownsville Charter School - K626 - K292 - 84K626 - 301 VERMONT STREET","8a283fb1-30f4-ea11-b882-24ee9a37d45c",-73893319,40671601,"I.S. 292 - BROOKLYN","301 VERMONT STREET"
1,0,1,"9669c231-32f4-ea11-b882-24ee9a37d45c","P.S. 201 The Discovery School for Inquiry and Research - Q201 - Q201 - 25Q201 - 65-11 155 STREET","9769c231-32f4-ea11-b882-24ee9a37d45c",-73813011,40736541,"P.S. 201 - QUEENS","65-11 155 STREET"
1,0,1,"28474313-33f4-ea11-b882-24ee9a37d45c","P.S. 091 Bronx - X091 - X091 - 10X091 - 2200 AQUEDUCT AVENUE","29474313-33f4-ea11-b882-24ee9a37d45c",-73907494,40858286,"P.S. 91 - BRONX","2200 AQUEDUCT AVENUE"
3,0,3,"2568ee1e-31f4-ea11-b882-24ee9a37d45c","P.S./I.S. 30 Mary White Ovington - K030 - K940 - 20K030 - 415 OVINGTON AVENUE","2668ee1e-31f4-ea11-b882-24ee9a37d45c",-74023036,40633710,"I.S. 30 - BROOKLYN","415 OVINGTON AVENUE"
3,0,3,"16a198c3-30f4-ea11-b882-24ee9a37d45c","P.S./I.S. 30 Mary White Ovington - K030 - K331 - 20K030 - 7002 4TH AVENUE","15a198c3-30f4-ea11-b882-24ee9a37d45c",-74023950,40633598,"P.S./I.S.30 MARY WHITE OVINGTON - BROOKLYN","7002 4TH AVENUE"
4,4,0,"66e2635c-32f4-ea11-b882-24ee9a37d45c","Hunters Point Community Middle School - Q291 - Q404 - 30Q291 - 1-50 51ST AVENUE","65e2635c-32f4-ea11-b882-24ee9a37d45c",-73959183,40742964,"HUNTERS POINT CAMPUS - QUEENS","1-50 51ST AVENUE"
4,2,2,"d08521d0-32f4-ea11-b882-24ee9a37d45c","Port Richmond School for Visionary Learning - R068 - R066 - 31R068 - 1625 FOREST AVENUE","d18521d0-32f4-ea11-b882-24ee9a37d45c",-74142526,40624781,"ECC @1625 FOREST AVENUE - STATEN ISLAND","1625 FOREST AVENUE"
4,3,1,"0baf0313-32f4-ea11-b882-24ee9a37d45c","P.S. 130 - Q130 - Q130 - 25Q130 - 200-01 42 AVENUE","04af0313-32f4-ea11-b882-24ee9a37d45c",-73784009,40760219,"P.S. 130 - QUEENS","200-01 42 AVENUE"
1,1,0,"f83159fa-30f4-ea11-b882-24ee9a37d45c","Transit Tech Career and Technical Education High School - K615 - K615 - 19K615 - 1 WELLS STREET","f93159fa-30f4-ea11-b882-24ee9a37d45c",-73875328,40678780,"E NY VOC HS OF TRANSIT TECH.-K","1 WELLS STREET"
5,4,1,"d60d3c5b-30f4-ea11-b882-24ee9a37d45c","P.S. 101 The Verrazano - K101 - K101 - 21K101 - 8696 24 Avenue","d70d3c5b-30f4-ea11-b882-24ee9a37d45c",-73991962,40597379,"P.S. 101 - BROOKLYN","8696 24 Avenue"
6,2,4,"4c8dbfcf-30f4-ea11-b882-24ee9a37d45c","Midwood High School - K405 - K405 - 22K405 - 2839 BEDFORD AVENUE","4d8dbfcf-30f4-ea11-b882-24ee9a37d45c",-73952356,40632829,"MIDWOOD HS - K","2839 BEDFORD AVENUE"
1,0,1,"553cbf01-ebf6-ea11-b883-24ee9a37d459","The David Marquis School of the Arts - R037 - R840 - 75R037 - 15 Fairfield Street","81be7adc-32f4-ea11-b882-24ee9a37d45c",-74151368,40564100,"P.S. 37 ( OLD I24X)-STATEN ISLAND","15 Fairfield Street"
2,2,0,"722f77fa-31f4-ea11-b882-24ee9a37d45c","J.H.S. 067 Louis Pasteur - Q067 - Q067 - 26Q067 - 51-60 MARATHON PARKWAY","732f77fa-31f4-ea11-b882-24ee9a37d45c",-73734832,40762241,"J.H.S. 67 - QUEENS","51-60 MARATHON PARKWAY"
3,2,1,"ec968d36-30f4-ea11-b882-24ee9a37d45c","P.S. 024 - K024 - K024 - 15K024 - 427 38 STREET","ed968d36-30f4-ea11-b882-24ee9a37d45c",-74004533,40652832,"P.S. 24 - BROOKLYN","427 38 STREET"
3,1,2,"f1b98b86-30f4-ea11-b882-24ee9a37d45c","P.S. 196 Ten Eyck - K196 - K196 - 14K196 - 207 BUSHWICK AVENUE","e9b98b86-30f4-ea11-b882-24ee9a37d45c",-73939385,40708804,"P.S. 196 - BROOKLYN","207 BUSHWICK AVENUE"
3,1,2,"2cff3d8d-33f4-ea11-b882-24ee9a37d45c","Health Opportunities High School - X670 - X884 - 07X670 - 350 Gerard Avenue","2dff3d8d-33f4-ea11-b882-24ee9a37d45c",-73929960,40815712,"HEALTH OPPORTUNITIES HS - X","350 Gerard Avenue"
2,0,2,"b8bf14dd-ebf6-ea11-b883-24ee9a37d459","The David Marquis School of the Arts - R037 - R844 - 75R037 - 200 Jefferson Blvd","8311b2e2-32f4-ea11-b882-24ee9a37d45c",-74182548,40543433,"P.S. 36 ANNEX - STATEN ISLAND","200 Jefferson Blvd"
2,0,2,"bf315367-30f4-ea11-b882-24ee9a37d45c","P.S. 123 Suydam - K123 - K123 - 32K123 - 100 IRVING AVENUE","bb315367-30f4-ea11-b882-24ee9a37d45c",-73922388,40704076,"P.S. 123 - BROOKLYN","100 IRVING AVENUE"
3,0,3,"dc0d3c5b-30f4-ea11-b882-24ee9a37d45c","P.S./I.S. 104 The Fort Hamilton School - K104 - K104 - 20K104 - 9115 5 AVENUE","dd0d3c5b-30f4-ea11-b882-24ee9a37d45c",-74028492,40618077,"P.S. 104 - BROOKLYN","9115 5 AVENUE"
1,1,0,"6cbc9674-32f4-ea11-b882-24ee9a37d45c","John Adams High School - Q480 - Q480 - 27Q480 - 101-01 ROCKAWAY BOULEVARD","6abc9674-32f4-ea11-b882-24ee9a37d45c",-73838616,40680065,"JOHN ADAMS HS - QUEENS","101-01 ROCKAWAY BOULEVARD"
3,1,2,"983c646f-e21e-eb11-b885-24ee9a37d45c","The David Marquis School of the Arts - R037 - R089 - 75R037 - 15a Fairfield Street","993c646f-e21e-eb11-b885-24ee9a37d45c",-74151375,40564093,"D75 REPLACEMENT @ 15 FAIRFIELD STREET - S.I.","15a Fairfield Street"
2,2,0,"4e6e70b7-31f4-ea11-b882-24ee9a37d45c","Community Health Academy of the Heights - M346 - M814 - 06M346 - 504 WEST 158TH STREET","4f6e70b7-31f4-ea11-b882-24ee9a37d45c",-73942074,40833695,"THE COMMUNITY HEALTH ACADEMY OF THE HEIGHTS - M","504 WEST 158TH STREET"
5,5,0,"9672c880-32f4-ea11-b882-24ee9a37d45c","High School for Construction Trades, Engineering and Architecture - Q650 - Q650 - 27Q650 - 94-06 104TH STREET","8f72c880-32f4-ea11-b882-24ee9a37d45c",-73841475,40689177,"HS FOR CONST.TRADES,ENGG.,& ARCH-Q","94-06 104TH STREET"
2,1,1,"46b4977a-32f4-ea11-b882-24ee9a37d45c","Aviation Career & Technical Education High School - Q610 - Q610 - 24Q610 - 45-30 36 STREET","44b4977a-32f4-ea11-b882-24ee9a37d45c",-73929577,40743309,"AVIATION HS - Q","45-30 36 STREET"
2,0,2,"12a6ba98-31f4-ea11-b882-24ee9a37d45c","Liberty High School Academy for Newcomers - M550 - M451 - 02M550 - 250 WEST 18 STREET","13a6ba98-31f4-ea11-b882-24ee9a37d45c",-74000238,40741820,"LIBERTY HS - MANHATTAN","250 WEST 18 STREET"
4,3,1,"6e36d900-33f4-ea11-b882-24ee9a37d45c","P.S. 056 Norwood Heights - X056 - X056 - 10X056 - 341 EAST 207 STREET","6f36d900-33f4-ea11-b882-24ee9a37d45c",-73874912,40875481,"P.S. 56 - BRONX","341 EAST 207 STREET"
2,0,2,"dbd096af-83ef-eb11-b8b1-24ee9a37d45c","P.S. M811 - Mickey Mantle School - M811 - M010 - 75M811 - 2581 7TH AVENUE","9b886843-31f4-ea11-b882-24ee9a37d45c",-73935746,40823988,"I.S. 10 (TANDEM M200) - MANHATTAN","2581 7TH AVENUE"
3,3,0,"29e61462-31f4-ea11-b882-24ee9a37d45c","P.S. 89 - M089 - M089 - 02M089 - 201 WARREN STREET","9741e65b-31f4-ea11-b882-24ee9a37d45c",-74013967,40717010,"P.S./I.S. 89 - MANHATTAN","201 WARREN STREET"
3,2,1,"b332c3fb-eaf6-ea11-b883-24ee9a37d459","Mosaic Pre-K Center - Q331 - Q392 - 24Q331 - 68-20 Myrtle Avenue","a2eb6056-32f4-ea11-b882-24ee9a37d45c",-73883878,40701694,"PRE-K CENTER @ 68-20 MYRTLE AVENUE - QUEENS","68-20 Myrtle Avenue"
2,1,1,"a32ff20c-32f4-ea11-b882-24ee9a37d45c","P.S. 101 School in the Gardens - Q101 - Q101 - 28Q101 - 2 RUSSELL PLACE","a42ff20c-32f4-ea11-b882-24ee9a37d45c",-73843400,40715543,"P.S. 101 - QUEENS","2 RUSSELL PLACE"
2,1,1,"b6315367-30f4-ea11-b882-24ee9a37d45c","P.S. 120 Carlos Tapia - K120 - K120 - 14K120 - 18 Beaver Street","b2315367-30f4-ea11-b882-24ee9a37d45c",-73937888,40700819,"P.S. 120 - BROOKLYN","18 Beaver Street"
3,3,0,"440d6d19-33f4-ea11-b882-24ee9a37d45c","P.S. 108 Philip J. Abinanti - X108 - X108 - 11X108 - 1166 NEILL AVENUE","450d6d19-33f4-ea11-b882-24ee9a37d45c",-73853200,40854700,"P.S. 108 - BRONX","1166 NEILL AVENUE"
6,5,1,"cbd27c6d-30f4-ea11-b882-24ee9a37d45c","P.S. 139 Alexine A. Fenty - K139 - K139 - 22K139 - 330 RUGBY ROAD","cad27c6d-30f4-ea11-b882-24ee9a37d45c",-73965862,40641340,"P.S. 139 - BROOKLYN","330 RUGBY ROAD"
3,1,2,"141bad3c-30f4-ea11-b882-24ee9a37d45c","I.S. 98 Bay Academy - K098 - K043 - 21K098 - 1401 EMMONS AVENUE","151bad3c-30f4-ea11-b882-24ee9a37d45c",-73954047,40583893,"I.S. 98 - BROOKLYN","1401 EMMONS AVENUE"
4,1,3,"10ba8b86-30f4-ea11-b882-24ee9a37d45c","P.S. 205 Clarion - K205 - K205 - 20K205 - 6701 20 AVENUE","11ba8b86-30f4-ea11-b882-24ee9a37d45c",-73986792,40614737,"P.S. 205 - BROOKLYN","6701 20 AVENUE"
1,0,1,"abdab801-ecf6-ea11-b883-24ee9a37d459","P.S. X721 - Stephen McSweeney School - X721 - X440 - 75X721 - 100 WEST MOSHOLU PARKWAY SOUTH","4cffcc6e-33f4-ea11-b882-24ee9a37d45c",-73889011,40879958,"DEWITT CLINTON HS - X","100 WEST MOSHOLU PARKWAY SOUTH"
4,2,2,"ebb98b86-30f4-ea11-b882-24ee9a37d45c","P.S. 194 Raoul Wallenberg - K194 - K194 - 22K194 - 3117 AVENUE W","ecb98b86-30f4-ea11-b882-24ee9a37d45c",-73934163,40598069,"P.S. 194 - BROOKLYN","3117 AVENUE W"
2,0,2,"d9d27c6d-30f4-ea11-b882-24ee9a37d45c","P.S. 147 Isaac Remsen - K147 - K147 - 14K147 - 325 BUSHWICK AVENUE","d4d27c6d-30f4-ea11-b882-24ee9a37d45c",-73938790,40705005,"P.S. 147 - BROOKLYN","325 BUSHWICK AVENUE"
3,2,1,"bebfa431-33f4-ea11-b882-24ee9a37d45c","South Bronx Preparatory: A College Board School - X221 - X149 - 07X221 - 360 EAST 145 STREET","bcbfa431-33f4-ea11-b882-24ee9a37d45c",-73920851,40813612,"J.H.S. 149 - BRONX","360 EAST 145 STREET"
5,3,2,"f9ae0313-32f4-ea11-b882-24ee9a37d45c","P.S. 124 Osmond A Church - Q124 - Q124 - 27Q124 - 129-15 150 AVENUE","faae0313-32f4-ea11-b882-24ee9a37d45c",-73811266,40665669,"P.S. 124 - QUEENS","129-15 150 AVENUE"
1,0,1,"aeedf392-32f4-ea11-b882-24ee9a37d45c","P.S. 188 Kingsbury - Q188 - Q858 - 26Q188 - 216-15 Peck Avenue","afedf392-32f4-ea11-b882-24ee9a37d45c",-73754390,40734924,"PS 188 Annex","216-15 Peck Avenue"
11,10,1,"5d07e99e-31f4-ea11-b882-24ee9a37d45c","Stuyvesant High School - M475 - M477 - 02M475 - 345 CHAMBERS STREET","5c07e99e-31f4-ea11-b882-24ee9a37d45c",-74013921,40718025,"STUYVESANT HS (NEW) - MANHATTAN","345 CHAMBERS STREET"
1,0,1,"f7d27c6d-30f4-ea11-b882-24ee9a37d45c","P.S. 153 Homecrest - K153 - K153 - 21K153 - 1970 HOMECREST AVENUE","f8d27c6d-30f4-ea11-b882-24ee9a37d45c",-73960027,40601179,"P.S. 153 - BROOKLYN","1970 HOMECREST AVENUE"
2,0,2,"480b210d-33f4-ea11-b882-24ee9a37d45c","P.S. X811 - X811 - X084 - 75X811 - 1434 Longfellow Avenue","490b210d-33f4-ea11-b882-24ee9a37d45c",-73886798,40830552,"P.S. 811 (OLD I84) - BRONX","1434 Longfellow Avenue"
2,1,1,"310410ca-32f4-ea11-b882-24ee9a37d45c","P.S. 052 John C. Thompson - R052 - R052 - 31R052 - 450 BUEL AVENUE","320410ca-32f4-ea11-b882-24ee9a37d45c",-74089012,40582550,"P.S. 52 - STATEN ISLAND","450 BUEL AVENUE"
2,2,0,"bd85f462-ebf6-ea11-b883-24ee9a37d459","P.S. M811 - Mickey Mantle School - M811 - M101 - 75M811 - 141 EAST 111 STREET","50e61462-31f4-ea11-b882-24ee9a37d45c",-73944546,40796098,"P.S. 101 - MANHATTAN","141 EAST 111 STREET"
3,1,2,"cbe8ce00-32f4-ea11-b882-24ee9a37d45c","I.S. 73 - The Frank Sansivieri Intermediate School - Q073 - Q073 - 24Q073 - 70-02 54 AVENUE","cce8ce00-32f4-ea11-b882-24ee9a37d45c",-73893318,40728558,"I.S. 73 - QUEENS","70-02 54 AVENUE"
2,1,1,"dd92e6d5-30f4-ea11-b882-24ee9a37d45c","Spring Creek Community School - K422 - K422 - 19K422 - 1065 Elton Street","da92e6d5-30f4-ea11-b882-24ee9a37d45c",-73874064,40657266,"SPRING CREEK EDUCATIONAL CAMPUS - BROOKLYN","1065 Elton Street"
1,1,0,"d5e0838c-31f4-ea11-b882-24ee9a37d45c","Lower Manhattan Community Middle School - M896 - M282 - 02M896 - 26 BROADWAY","d1e0838c-31f4-ea11-b882-24ee9a37d45c",-74013303,40705688,"BROADWAY EDUCATION CAMPUS - M","26 BROADWAY"
2,0,2,"7e34aa92-31f4-ea11-b882-24ee9a37d45c","Quest to Learn - M422 - M440 - 02M422 - 351 WEST 18 STREET","7834aa92-31f4-ea11-b882-24ee9a37d45c",-74002540,40743407,"BAYARD RUSTIN EDUCATIONAL COMP-M","351 WEST 18 STREET"
3,1,2,"b748b1f5-eaf6-ea11-b883-24ee9a37d459","P.S. M226 - M226 - M475 - 75M226 - 345 East 15th Street","5607e99e-31f4-ea11-b882-24ee9a37d45c",-73982590,40732665,"HEALTH PROFESSIONS HS (OL STY) - M","345 East 15th Street"
10,4,6,"1c7eed06-32f4-ea11-b882-24ee9a37d45c","P.S. 090 Horace Mann - Q090 - Q090 - 27Q090 - 86-50 109 STREET","1d7eed06-32f4-ea11-b882-24ee9a37d45c",-73839517,40696653,"P.S. 90 - QUEENS","86-50 109 STREET"
2,2,0,"e78442ee-31f4-ea11-b882-24ee9a37d45c","P.S. 041 Crocheron - Q041 - Q041 - 26Q041 - 214-43 35 AVENUE","e58442ee-31f4-ea11-b882-24ee9a37d45c",-73771225,40770155,"P.S. 41 - QUEENS","214-43 35 AVENUE"
1,1,0,"bdba3c50-33f4-ea11-b882-24ee9a37d45c","Mount Eden Children's Academy - X555 - X240 - 09X555 - 1501 JEROME AVENUE","baba3c50-33f4-ea11-b882-24ee9a37d45c",-73916084,40842503,"DOE NEW SETTLEMENT COMMUNITY CAMPUS - X","1501 JEROME AVENUE"
9,6,3,"410b210d-33f4-ea11-b882-24ee9a37d45c","P.S. 081 Robert J. Christen - X081 - X081 - 10X081 - 5550 RIVERDALE AVENUE","420b210d-33f4-ea11-b882-24ee9a37d45c",-73904657,40903275,"P.S. 81 - BRONX","5550 RIVERDALE AVENUE"
1,0,1,"aa2ff20c-32f4-ea11-b882-24ee9a37d45c","P.S. 104 The Bays Water - Q104 - Q104 - 27Q104 - 26-01 MOTT AVENUE","3c7eed06-32f4-ea11-b882-24ee9a37d45c",-73764621,40608002,"P.S. 104 - QUEENS","26-01 MOTT AVENUE"
2,0,2,"85be7adc-32f4-ea11-b882-24ee9a37d45c","P.S. 74 Future Leaders Elementary School - R074 - R831 - 31R074 - 211 DANIEL LOW TERRACE","86be7adc-32f4-ea11-b882-24ee9a37d45c",-74079438,40638993,"P.S. 74 - STATEN ISLAND","211 DANIEL LOW TERRACE"
1,0,1,"7841e65b-31f4-ea11-b882-24ee9a37d45c","P.S. M079 - Horan School - M079 - M079 - 75M079 - 55 East 120 Street","7741e65b-31f4-ea11-b882-24ee9a37d45c",-73942009,40802547,"P.S. 79 (MULT. HANDICAP) - M","55 East 120 Street"
5,3,2,"69fdc1bd-32f4-ea11-b882-24ee9a37d45c","P.S. 022 Graniteville - R022 - R022 - 31R022 - 1860 Forest Avenue","6afdc1bd-32f4-ea11-b882-24ee9a37d45c",-74150544,40624847,"P.S. 22 - STATEN ISLAND","1860 Forest Avenue"
5,5,0,"1e06003e-32f4-ea11-b882-24ee9a37d45c","East-West School of International Studies - Q281 - Q237 - 25Q281 - 46-21 COLDEN STREET","1b06003e-32f4-ea11-b882-24ee9a37d45c",-73821402,40749430,"J.H.S. 237 - QUEENS","46-21 COLDEN STREET"
2,2,0,"33474313-33f4-ea11-b882-24ee9a37d45c","Ampark Neighborhood - X344 - X095 - 10X344 - 3961 HILLMAN AVENUE","34474313-33f4-ea11-b882-24ee9a37d45c",-73891664,40883049,"P.S. 95 - BRONX","3961 HILLMAN AVENUE"
3,1,2,"ef9b4c1f-32f4-ea11-b882-24ee9a37d45c","J.H.S. 157 Stephen A. Halsey - Q157 - Q157 - 28Q157 - 63-55 102ND STREET","f09b4c1f-32f4-ea11-b882-24ee9a37d45c",-73852879,40732348,"J.H.S. 157 - QUEENS","63-55 102ND STREET"
1,1,0,"8be657bd-30f4-ea11-b882-24ee9a37d45c","Urban Assembly Institute of Math and Science for Young Women - K527 - K313 - 13K527 - 283 ADAMS STREET","82e657bd-30f4-ea11-b882-24ee9a37d45c",-73988323,40694629,"ADAMS STREET EDUCATIONAL CAMPUS - K","283 ADAMS STREET"
5,4,1,"d2b66262-32f4-ea11-b882-24ee9a37d45c","Forest Hills High School - Q440 - Q440 - 28Q440 - 67-01 110 STREET","d3b66262-32f4-ea11-b882-24ee9a37d45c",-73843972,40730017,"FOREST HILLS HS - Q","67-01 110 STREET"
1,1,0,"df8521d0-32f4-ea11-b882-24ee9a37d45c","P.S. 048 William G. Wilcox - R048 - R071 - 31R048 - 1050 Targee Street","db8521d0-32f4-ea11-b882-24ee9a37d45c",-74091239,40603492,"P.S./I.S. 48 - Staten Island","1050 Targee Street"
8,5,3,"42a10a44-32f4-ea11-b882-24ee9a37d45c","New York City Academy for Discovery - Q306 - Q262 - 27Q306 - 95-16 89TH AVENUE","43a10a44-32f4-ea11-b882-24ee9a37d45c",-73848577,40691482,"P.S. 262 - QUEENS","95-16 89TH AVENUE"
1,1,0,"818946f4-31f4-ea11-b882-24ee9a37d45c","P.S. 056 Harry Eichler - Q056 - Q056 - 27Q056 - 86-10 114 STREET","828946f4-31f4-ea11-b882-24ee9a37d45c",-73835735,40698989,"P.S. 56 (OLD R HILL AX) - QUEENS","86-10 114 STREET"
3,2,1,"7da9d9c3-32f4-ea11-b882-24ee9a37d45c","P.S. 030 Westerleigh - R030 - R030 - 31R030 - 200 Wardwell Avenue","73a9d9c3-32f4-ea11-b882-24ee9a37d45c",-74133080,40618097,"P.S. 30 - STATEN ISLAND","200 Wardwell Avenue"
3,1,2,"31eabc42-30f4-ea11-b882-24ee9a37d45c","Achievement First Brownsville Charter School - K626 - K055 - 84K626 - 2021 BERGEN STREET","32eabc42-30f4-ea11-b882-24ee9a37d45c",-73912685,40674456,"I.S. 55 - BROOKLYN","2021 BERGEN STREET"
3,3,0,"26c73b4a-32f4-ea11-b882-24ee9a37d45c","A.C.E. Academy for Scholars at the Geraldine Ferraro Campus - Q290 - Q290 - 24Q290 - 55-20 METROPOLITAN AVENUE","24c73b4a-32f4-ea11-b882-24ee9a37d45c",-73908307,40713030,"THE GERALDINE FERRARO CAMPUS - QUEENS","55-20 METROPOLITAN AVENUE"
2,1,1,"652f77fa-31f4-ea11-b882-24ee9a37d45c","P. S. 62 - Chester Park School - Q062 - Q062 - 27Q062 - 97-25 108 STREET","642f77fa-31f4-ea11-b882-24ee9a37d45c",-73835567,40688359,"P.S. 62 - QUEENS","97-25 108 STREET"
3,3,0,"6f41e65b-31f4-ea11-b882-24ee9a37d45c","P.S. 075 Emily Dickinson - M075 - M075 - 03M075 - 735 WEST END AVENUE","6a41e65b-31f4-ea11-b882-24ee9a37d45c",-73973996,40795109,"P.S. 75 - MANHATTAN","735 WEST END AVENUE"
2,0,2,"64395a2c-ebf6-ea11-b883-24ee9a37d459","Achievement First Apollo Charter School - K774 - K292 - 84K774 - 301 VERMONT STREET","8a283fb1-30f4-ea11-b882-24ee9a37d45c",-73893319,40671601,"I.S. 292 - BROOKLYN","301 VERMONT STREET"
6,6,0,"df883319-32f4-ea11-b882-24ee9a37d45c","P.S. 144 Col Jeromus Remsen - Q144 - Q144 - 28Q144 - 69-20 JUNO STREET","e0883319-32f4-ea11-b882-24ee9a37d45c",-73852398,40714890,"P.S. 144 - QUEENS","69-20 JUNO STREET"
1,1,0,"d0fab455-31f4-ea11-b882-24ee9a37d45c","The STAR Academy - P.S.63 - M063 - M063 - 01M063 - 121 EAST 3 STREET","cefab455-31f4-ea11-b882-24ee9a37d45c",-73986214,40724440,"P.S. 63 - MANHATTAN","121 EAST 3 STREET"
2,1,1,"2baf0313-32f4-ea11-b882-24ee9a37d45c","P.S. 139 Rego Park - Q139 - Q139 - 28Q139 - 93-06 63 DRIVE","29af0313-32f4-ea11-b882-24ee9a37d45c",-73862561,40728012,"P.S. 139 - QUEENS","93-06 63 DRIVE"
2,0,2,"56f4a0ef-eaf6-ea11-b883-24ee9a37d459","Achievement First Voyager Charter School - K876 - K092 - 84K876 - 601 PARKSIDE AVENUE","86d92255-30f4-ea11-b882-24ee9a37d45c",-73953810,40656276,"P.S. 92 - BROOKLYN","601 PARKSIDE AVENUE"
2,1,1,"186e3d68-31f4-ea11-b882-24ee9a37d45c","P.S. 115 Alexander Humboldt - M115 - M115 - 06M115 - 586 WEST 177 STREET","166e3d68-31f4-ea11-b882-24ee9a37d45c",-73935140,40846116,"P.S. 115 - MANHATTAN","586 WEST 177 STREET"
2,1,1,"409f4974-31f4-ea11-b882-24ee9a37d45c","J.H.S. 143 Eleanor Roosevelt - M143 - M143 - 06M143 - 511 WEST 182ND STREET","3f9f4974-31f4-ea11-b882-24ee9a37d45c",-73930991,40849311,"I.S. 143 - MANHATTAN","511 WEST 182ND STREET"
1,0,1,"8c977d2b-32f4-ea11-b882-24ee9a37d45c","P.S. 195 William Haberle - Q195 - Q195 - 29Q195 - 253-50 149 Avenue","8d977d2b-32f4-ea11-b882-24ee9a37d45c",-73735618,40652641,"P.S. 195 - QUEENS","253-50 149 Avenue"
2,0,2,"b89c11e8-30f4-ea11-b882-24ee9a37d45c","The Brooklyn School for Social Justice - K549 - K480 - 32K549 - 400 IRVING AVENUE","b39c11e8-30f4-ea11-b882-24ee9a37d45c",-73911751,40696457,"BUSHWICK EDUCATIONAL CAMPUS - K","400 IRVING AVENUE"
2,1,1,"8d83ff9e-30f4-ea11-b882-24ee9a37d45c","P.S. 247 Brooklyn - K247 - K247 - 20K247 - 7000 21 AVENUE","8e83ff9e-30f4-ea11-b882-24ee9a37d45c",-73987195,40612247,"P.S. 247 - BROOKLYN","7000 21 AVENUE"
2,0,2,"1530f69f-ebf6-ea11-b883-24ee9a37d459","P.S. Q993 - Q993 - Q208 - 75Q993 - 74-30 COMMONWEALTH BLVD","ab69c231-32f4-ea11-b882-24ee9a37d45c",-73727632,40744276,"P.S./I.S. 208 - QUEENS","74-30 COMMONWEALTH BLVD"
4,3,1,"6541e65b-31f4-ea11-b882-24ee9a37d45c","New York City Lab Middle School for Collaborative Studies - M312 - M070 - 02M312 - 333 WEST 17 STREET","defab455-31f4-ea11-b882-24ee9a37d45c",-74002222,40742512,"I.S. 70 - MANHATTAN","333 WEST 17 STREET"
1,1,0,"c2fc24e8-31f4-ea11-b882-24ee9a37d45c","World Journalism Preparatory: A College Board School - Q285 - Q025 - 25Q285 - 34-65 192 STREET","befc24e8-31f4-ea11-b882-24ee9a37d45c",-73789365,40764884,"J.H.S. 25 - QUEENS","34-65 192 STREET"
1,0,1,"e62d6c32-ebf6-ea11-b883-24ee9a37d459","P.S. K771 - K771 - K329 - 75K771 - 2929 WEST 30 STREET","11a198c3-30f4-ea11-b882-24ee9a37d45c",-73995770,40574666,"P.S. 329 - BROOKLYN","2929 WEST 30 STREET"
3,1,2,"e28442ee-31f4-ea11-b882-24ee9a37d45c","P.S. 040 Samuel Huntington - Q040 - Q040 - 28Q040 - 109-20 Union Hall Street","dd8442ee-31f4-ea11-b882-24ee9a37d45c",-73790975,40693559,"P.S. 40 (D28) - QUEENS","109-20 Union Hall Street"
2,2,0,"418dbfcf-30f4-ea11-b882-24ee9a37d45c","Kingsborough Early College School - K468 - K400 - 21K468 - 2630 BENSON AVENUE","3a8dbfcf-30f4-ea11-b882-24ee9a37d45c",-73986313,40593028,"Lafayette Educational Campus","2630 BENSON AVENUE"
3,3,0,"4ba10a44-32f4-ea11-b882-24ee9a37d45c","P.S./I.S. 266 - Q266 - Q266 - 26Q266 - 74-10 COMMONWEALTH BOULEVARD","4aa10a44-32f4-ea11-b882-24ee9a37d45c",-73728415,40746128,"P.S./I.S. 266 - QUEENS","74-10 COMMONWEALTH BOULEVARD"
4,2,2,"d90d3c5b-30f4-ea11-b882-24ee9a37d45c","P.S. 102 The Bayview - K102 - K102 - 20K102 - 211 72 STREET","da0d3c5b-30f4-ea11-b882-24ee9a37d45c",-74028758,40634318,"P.S. 102 - BROOKLYN","211 72 STREET"
1,0,1,"84f4a0ef-eaf6-ea11-b883-24ee9a37d459","The Joan Snow Pre-K Center - K853 - K765 - 22K853 - 1139 Coney Island Avenue","4f2f7d06-31f4-ea11-b882-24ee9a37d45c",-73966208,40630109,"PRE-K CENTER @1139 CONEY ISLAND AVENUE - BROOKLYN","1139 Coney Island Avenue"
1,1,0,"cab36d80-30f4-ea11-b882-24ee9a37d45c","P.S. 184 Newport - K184 - K184 - 23K184 - 273 NEWPORT STREET","c8b36d80-30f4-ea11-b882-24ee9a37d45c",-73905004,40660385,"P.S. 184 - BROOKLYN","273 NEWPORT STREET"
1,0,1,"db37fba4-31f4-ea11-b882-24ee9a37d45c","Cascades High School - M650 - M510 - 01M650 - 198 Forsyth Street","d737fba4-31f4-ea11-b882-24ee9a37d45c",-73990468,40722415,"FORSYTH HS (AUXSVC-OLD 91) - M","198 Forsyth Street"
2,1,1,"75bc9674-32f4-ea11-b882-24ee9a37d45c","Grover Cleveland High School - Q485 - Q485 - 24Q485 - 21-27 HIMROD STREET","74bc9674-32f4-ea11-b882-24ee9a37d45c",-73909202,40711881,"GROVER CLEVELAND HS - Q","21-27 HIMROD STREET"
1,1,0,"f309e2e1-30f4-ea11-b882-24ee9a37d45c","District 20 Pre-K Center - K768 - K453 - 20K768 - 8501 5TH AVENUE","f409e2e1-30f4-ea11-b882-24ee9a37d45c",-74025734,40622039,"PRE-K CENTER @8501 5TH AVENUE - BROOKLYN","8501 5TH AVENUE"
1,0,1,"b669c231-32f4-ea11-b882-24ee9a37d45c","P.S. 209 Clearview Gardens - Q209 - Q209 - 25Q209 - 16-10 Utopia Parkway","b569c231-32f4-ea11-b882-24ee9a37d45c",-73795845,40783777,"P.S. 209 - QUEENS","16-10 Utopia Parkway"
3,2,1,"f0f22ce2-31f4-ea11-b882-24ee9a37d45c","York Early College Academy - Q284 - Q008 - 28Q284 - 108-35 167 STREET","f1f22ce2-31f4-ea11-b882-24ee9a37d45c",-73786403,40696910,"J.H.S. 8 - QUEENS","108-35 167 STREET"
1,1,0,"68e2635c-32f4-ea11-b882-24ee9a37d45c","Academy for Careers in Television and Film - Q301 - Q404 - 30Q301 - 1-50 51ST AVENUE","65e2635c-32f4-ea11-b882-24ee9a37d45c",-73959183,40742964,"HUNTERS POINT CAMPUS - QUEENS","1-50 51ST AVENUE"
4,4,0,"9969c231-32f4-ea11-b882-24ee9a37d45c","J.H.S. 202 Robert H. Goddard - Q202 - Q202 - 27Q202 - 138-30 LAFAYETTE STREET","9169c231-32f4-ea11-b882-24ee9a37d45c",-73845992,40670905,"I.S. 202 - QUEENS","138-30 LAFAYETTE STREET"
1,1,0,"7dc280bd-31f4-ea11-b882-24ee9a37d45c","Manhattan Village Academy - M439 - M873 - 02M439 - 43 WEST 22 STREET","7ec280bd-31f4-ea11-b882-24ee9a37d45c",-73991966,40741963,"MANHATTAN VILLAGE ACADEMY - M","43 WEST 22 STREET"
3,0,3,"a5edf392-32f4-ea11-b882-24ee9a37d45c","Joseph F. Quinn Intermediate School 77 - Q077 - Q849 - 24Q077 - 976 Seneca Avenue","a4edf392-32f4-ea11-b882-24ee9a37d45c",-73902147,40699101,"I.S. 77 - QUEENS","976 Seneca Avenue"
1,1,0,"2c06003e-32f4-ea11-b882-24ee9a37d45c","P.S. 242 Leonard P. Stavisky Early Childhood School - Q242 - Q242 - 25Q242 - 29-66 137 STREET","2d06003e-32f4-ea11-b882-24ee9a37d45c",-73832005,40769752,"P.S. 242 - (ECC) - QUEENS","29-66 137 STREET"
2,1,1,"7303194f-30f4-ea11-b882-24ee9a37d45c","P.S. 69 Vincent D. Grippo School - K069 - K069 - 20K069 - 6302 9TH AVENUE","7203194f-30f4-ea11-b882-24ee9a37d45c",-74009752,40632392,"P.S. 69 - BROOKLYN","6302 9TH AVENUE"
3,2,1,"af0e6e25-32f4-ea11-b882-24ee9a37d45c","P.S. 184 Flushing Manor - Q184 - Q184 - 25Q184 - 163-15 21 ROAD","b00e6e25-32f4-ea11-b882-24ee9a37d45c",-73799158,40778334,"P.S. 184 - QUEENS","163-15 21 ROAD"
1,1,0,"e7883319-32f4-ea11-b882-24ee9a37d45c","P.S. 146 Howard Beach - Q146 - Q146 - 27Q146 - 98-01 159 AVENUE","e8883319-32f4-ea11-b882-24ee9a37d45c",-73834896,40660531,"P.S. 146 - QUEENS","98-01 159 AVENUE"
1,0,1,"e2e0a4fb-ebf6-ea11-b883-24ee9a37d459","P.S. X010 - X010 - X240 - 75X010 - 1501 JEROME AVENUE","baba3c50-33f4-ea11-b882-24ee9a37d45c",-73916084,40842503,"DOE NEW SETTLEMENT COMMUNITY CAMPUS - X","1501 JEROME AVENUE"
1,0,1,"1412a0be-ebf6-ea11-b883-24ee9a37d459","P.S. Q233 - Q233 - Q875 - 75Q233 - 114-43 142 Street","c3edf392-32f4-ea11-b882-24ee9a37d45c",-73800875,40683473,"P.S. 233 MINISCHOOL2 (OLD P752)-Q","114-43 142 Street"
3,2,1,"31005d7a-31f4-ea11-b882-24ee9a37d45c","P.S. 165 Robert E. Simon - M165 - M165 - 03M165 - 234 West 109 Street","2f005d7a-31f4-ea11-b882-24ee9a37d45c",-73965949,40802653,"P.S. 165 - MANHATTAN","234 West 109 Street"
2,0,2,"e29319d7-ebf6-ea11-b883-24ee9a37d459","The Richmond Pre-K Center - R066 - R113 - 31R066 - 841 FATHER CAPODANNO BOULEVARD","f98521d0-32f4-ea11-b882-24ee9a37d45c",-74083885,40575592,"3K CENTER @ FATHER CAPODANNO BOULEVARD - STATEN IS","841 FATHER CAPODANNO BOULEVARD"
3,3,0,"692f77fa-31f4-ea11-b882-24ee9a37d45c","P.S. 063 Old South - Q063 - Q063 - 27Q063 - 90-15 SUTTER AVENUE","6a2f77fa-31f4-ea11-b882-24ee9a37d45c",-73846796,40676978,"P.S. 63 - QUEENS","90-15 SUTTER AVENUE"
3,1,2,"bc56635c-33f4-ea11-b882-24ee9a37d45c","Schuylerville Preparatory High School - X348 - X405 - 08X348 - 3000 EAST TREMONT AVENUE","b556635c-33f4-ea11-b882-24ee9a37d45c",-73839583,40839775,"HERBERT H. LEHMAN HS - X","3000 EAST TREMONT AVENUE"
2,1,1,"5ca5db98-30f4-ea11-b882-24ee9a37d45c","P.S. 236 Mill Basin - K236 - K236 - 22K236 - 6302 AVENUE U","5ba5db98-30f4-ea11-b882-24ee9a37d45c",-73912005,40615494,"P.S. 236 - BROOKLYN","6302 AVENUE U"
3,2,1,"626e70b7-31f4-ea11-b882-24ee9a37d45c","High School for Environmental Studies - M400 - M834 - 02M400 - 444 WEST 56 STREET","5d6e70b7-31f4-ea11-b882-24ee9a37d45c",-73988610,40767848,"HS FOR ENVIRONMENTAL STUDIES - M","444 WEST 56 STREET"
4,1,3,"822f77fa-31f4-ea11-b882-24ee9a37d45c","P.S. 071 Forest - Q071 - Q071 - 24Q071 - 62-85 FOREST AVENUE","802f77fa-31f4-ea11-b882-24ee9a37d45c",-73904798,40711388,"P.S. 71 - QUEENS","62-85 FOREST AVENUE"
3,3,0,"c52ff20c-32f4-ea11-b882-24ee9a37d45c","P.S./I.S. 113 Anthony J. Pranzo - Q113 - Q113 - 24Q113 - 78-23 87TH STREET","c62ff20c-32f4-ea11-b882-24ee9a37d45c",-73861493,40705476,"P.S./I.S. 113 - QUEENS","78-23 87TH STREET"
58,58,0,"3088e6db-30f4-ea11-b882-24ee9a37d45c","Brooklyn Technical High School - K430 - K430 - 13K430 - 29 FT GREENE PLACE","3188e6db-30f4-ea11-b882-24ee9a37d45c",-73976435,40688896,"BROOKLYN TECH HS - K","29 FT GREENE PLACE"
4,1,3,"34e85c61-30f4-ea11-b882-24ee9a37d45c","P.S. 116 Elizabeth L Farrell - K116 - K116 - 32K116 - 515 KNICKERBOCKER AVENUE","35e85c61-30f4-ea11-b882-24ee9a37d45c",-73916563,40698077,"P.S. 116 - BROOKLYN","515 KNICKERBOCKER AVENUE"
2,2,0,"88a9d9c3-32f4-ea11-b882-24ee9a37d45c","I.S. 034 Tottenville - R034 - R034 - 31R034 - 528 ACADEMY AVENUE","87a9d9c3-32f4-ea11-b882-24ee9a37d45c",-74243400,40508300,"I.S. 34 (OLD TOTTENVILLE) - S.I","528 ACADEMY AVENUE"
2,1,1,"9ee657bd-30f4-ea11-b882-24ee9a37d45c","I.S. 318 Eugenio Maria De Hostos - K318 - K318 - 14K318 - 101 WALTON STREET","9de657bd-30f4-ea11-b882-24ee9a37d45c",-73948771,40703034,"I.S. 318 - BROOKLYN","101 WALTON STREET"
1,1,0,"69e95536-4afb-ea11-b883-24ee9a37d459","Rainbow - Little Neck - QBLV - QBLV -  - 25021 Northern Boulevard","6ae95536-4afb-ea11-b883-24ee9a37d459",-73737064,40768826,"Rainbow - Little Neck","25021 Northern Boulevard"
2,0,2,"f1d10307-33f4-ea11-b882-24ee9a37d45c","P.S. 071 Rose E. Scala - X071 - X071 - 08X071 - 3040 ROBERTS AVENUE","e3d10307-33f4-ea11-b882-24ee9a37d45c",-73829562,40845379,"P.S. 71 - BRONX","3040 ROBERTS AVENUE"
1,0,1,"ab8fd48d-ebf6-ea11-b883-24ee9a37d459","P.S. Q993 - Q993 - Q041 - 75Q993 - 214-43 35 AVENUE","e58442ee-31f4-ea11-b882-24ee9a37d45c",-73771225,40770155,"P.S. 41 - QUEENS","214-43 35 AVENUE"
4,1,3,"3d0410ca-32f4-ea11-b882-24ee9a37d45c","P.S. 56 The Louis Desario School - R056 - R056 - 31R056 - 250 KRAMER AVENUE","3e0410ca-32f4-ea11-b882-24ee9a37d45c",-74213943,40541856,"P.S. 56 - STATEN ISLAND","250 KRAMER AVENUE"
3,2,1,"42e61462-31f4-ea11-b882-24ee9a37d45c","P.S. 096 Joseph Lanzetta - M096 - M096 - 04M096 - 216 EAST 120 STREET","43e61462-31f4-ea11-b882-24ee9a37d45c",-73937179,40799690,"P.S. 96 - MANHATTAN","216 EAST 120 STREET"
1,1,0,"307c21b7-32f4-ea11-b882-24ee9a37d45c","I.S. R002 George L. Egbert - R002 - R002 - 31R002 - 333 Midland Avenue","2b7c21b7-32f4-ea11-b882-24ee9a37d45c",-74099685,40576728,"I.S. 2 - STATEN ISLAND","333 Midland Avenue"
1,1,0,"7bc0b892-49fb-ea11-b883-24ee9a37d459","MERCEDES MAGALLANES-CLARIS - FL1 - XBPV - XBPJ -  - 563 VANNEST AVENUE","7cc0b892-49fb-ea11-b883-24ee9a37d459",-73869113,40842059,"563 VANNEST AVENUE","563 VANNEST AVENUE"
5,5,0,"7707e99e-31f4-ea11-b882-24ee9a37d45c","P.S. 059 Beekman Hill International - M059 - M488 - 02M059 - 231-249 EAST 56 STREET","6d07e99e-31f4-ea11-b882-24ee9a37d45c",-73967204,40759248,"MIDTOWN EAST CAMPUS - MANHATTAN","231-249 EAST 56 STREET"
2,1,1,"f0d27c6d-30f4-ea11-b882-24ee9a37d45c","School of Science & Technology - K152 - K152 - 22K152 - 725 EAST 23 STREET","efd27c6d-30f4-ea11-b882-24ee9a37d45c",-73954269,40632619,"P.S. 152 - BROOKLYN","725 EAST 23 STREET"
2,1,1,"1de85c61-30f4-ea11-b882-24ee9a37d45c","Achievement First East New York Charter School - K358 - K111 - 84K358 - 35 STARR STREET","18e85c61-30f4-ea11-b882-24ee9a37d45c",-73927938,40700810,"I.S. 111 - BROOKLYN","35 STARR STREET"
1,1,0,"bc315367-30f4-ea11-b882-24ee9a37d45c","P.S. 121 Nelson A. Rockefeller - K121 - K121 - 21K121 - 5301 20 AVENUE","bd315367-30f4-ea11-b882-24ee9a37d45c",-73978472,40622671,"P.S. 121 - BROOKLYN","5301 20 AVENUE"
3,1,2,"5b5b4cd6-32f4-ea11-b882-24ee9a37d45c","Curtis High School - R450 - R450 - 31R450 - 105 HAMILTON AVENUE","5a5b4cd6-32f4-ea11-b882-24ee9a37d45c",-74082149,40645436,"CURTIS HS - S. I.","105 HAMILTON AVENUE"
1,0,1,"ffb98b86-30f4-ea11-b882-24ee9a37d45c","P.S. 200 Benson School - K200 - K200 - 20K200 - 1940 BENSON AVENUE","00ba8b86-30f4-ea11-b882-24ee9a37d45c",-74001915,40602809,"P.S. 200 - BROOKLYN","1940 BENSON AVENUE"
1,0,1,"130410ca-32f4-ea11-b882-24ee9a37d45c","CSI High School for International Studies - R047 - R043 - 31R047 - 100 ESSEX DRIVE","a0a9d9c3-32f4-ea11-b882-24ee9a37d45c",-74159343,40581958,"JEROME PARKER CAMPUS - S.I.","100 ESSEX DRIVE"
3,1,2,"b9b66262-32f4-ea11-b882-24ee9a37d45c","John Bowne High School - Q425 - Q425 - 25Q425 - 63-25 MAIN STREET","bab66262-32f4-ea11-b882-24ee9a37d45c",-73823841,40737448,"JOHN BOWNE HS - QUEENS","63-25 MAIN STREET"
1,0,1,"74886843-31f4-ea11-b882-24ee9a37d45c","P.S. Q256 - Q256 - L001 - 75Q256 - 525 CONVENT ROAD","75886843-31f4-ea11-b882-24ee9a37d45c",0,0,"P.S. 256 AX @ ST MARY FAM SERV-Q-S","525 CONVENT ROAD"
3,2,1,"339ebaee-32f4-ea11-b882-24ee9a37d45c","P.S. 016 Wakefield - X016 - X016 - 11X016 - 4550 CARPENTER AVENUE","349ebaee-32f4-ea11-b882-24ee9a37d45c",-73854231,40902311,"P.S. 16 - BRONX","4550 CARPENTER AVENUE"
1,0,1,"b1eb5090-85ef-eb11-b8b1-24ee9a37d45c","P.S. X010 - X010 - X067 - 75X010 - 2024 MOHEGAN AVENUE","e6d10307-33f4-ea11-b882-24ee9a37d45c",-73884192,40843781,"P.S. 67 - BRONX","2024 MOHEGAN AVENUE"
8,8,0,"512b3eee-30f4-ea11-b882-24ee9a37d45c","Fort Hamilton High School - K490 - K490 - 20K490 - 8301 SHORE ROAD","522b3eee-30f4-ea11-b882-24ee9a37d45c",-74038103,40626827,"FORT HAMILTON HS - K","8301 SHORE ROAD"
1,0,1,"018bc007-ebf6-ea11-b883-24ee9a37d459","Bronx Charter School for Better Learning - X718 - X937 - 84X718 - 3740 BAYCHESTER AVENUE","20497593-33f4-ea11-b882-24ee9a37d45c",-73839288,40884371,"BX CHARTER SCH FOR BETTER LRNG - X","3740 BAYCHESTER AVENUE"
5,2,3,"83e03d56-33f4-ea11-b882-24ee9a37d45c","Morris Academy for Collaborative Studies - X297 - X400 - 09X297 - 1110 BOSTON ROAD","82e03d56-33f4-ea11-b882-24ee9a37d45c",-73903920,40827455,"MORRIS HS - X","1110 BOSTON ROAD"
4,2,2,"752f77fa-31f4-ea11-b882-24ee9a37d45c","P.S. 068 Cambridge - Q068 - Q068 - 24Q068 - 59-09 SAINT FELIX AVENUE","762f77fa-31f4-ea11-b882-24ee9a37d45c",-73897372,40696961,"P.S. 68 - QUEENS","59-09 SAINT FELIX AVENUE"
2,0,2,"e38521d0-32f4-ea11-b882-24ee9a37d45c","I.S. 072 Rocco Laurie - R072 - R072 - 31R072 - 33 FERNDALE AVENUE","e48521d0-32f4-ea11-b882-24ee9a37d45c",-74158618,40592132,"I.S. 72 - STATEN ISLAND","33 FERNDALE AVENUE"
4,3,1,"370410ca-32f4-ea11-b882-24ee9a37d45c","P.S. 054 Charles W. Leng - R054 - R054 - 31R054 - 1060 WILLOWBROOK ROAD","380410ca-32f4-ea11-b882-24ee9a37d45c",-74137259,40602779,"P.S. 54 - STATEN ISLAND","1060 WILLOWBROOK ROAD"
1,0,1,"8f886843-31f4-ea11-b882-24ee9a37d45c","P.S. 007 Samuel Stern - M007 - M007 - 04M007 - 160 EAST 120 STREET","90886843-31f4-ea11-b882-24ee9a37d45c",-73939374,40800616,"P.S. 7 - MANHATTAN","160 EAST 120 STREET"
1,0,1,"4f5bc58c-30f4-ea11-b882-24ee9a37d45c","P.S. K231 - K231 - K215 - 75K231 - 415 AVENUE S","505bc58c-30f4-ea11-b882-24ee9a37d45c",-73970171,40602722,"P.S. 215 - BROOKLYN","415 AVENUE S"
2,0,2,"1606003e-32f4-ea11-b882-24ee9a37d45c","P.S. 234 - Q234 - Q234 - 30Q234 - 30-15 29 STREET","1506003e-32f4-ea11-b882-24ee9a37d45c",-73923044,40766898,"P.S. 234 - QUEENS","30-14 30 STREET"
6,3,3,"ace657bd-30f4-ea11-b882-24ee9a37d45c","P.S. 321 William Penn - K321 - K321 - 15K321 - 180 7 AVENUE","ade657bd-30f4-ea11-b882-24ee9a37d45c",-73978633,40671816,"P.S. 321 - BROOKLYN","180 7 AVENUE"
1,1,0,"13e2abc9-30f4-ea11-b882-24ee9a37d45c","P.S. 376 - K376 - K376 - 32K376 - 194 HARMAN STREET","14e2abc9-30f4-ea11-b882-24ee9a37d45c",-73920187,40698050,"P.S. 376A - BROOKLYN","194 HARMAN STREET"
1,1,0,"a369c231-32f4-ea11-b882-24ee9a37d45c","Energy Tech High School - Q258 - Q204 - 30Q258 - 36-41 28 STREET","9c69c231-32f4-ea11-b882-24ee9a37d45c",-73932628,40756471,"I.S. 204 - QUEENS","36-41 28 STREET"
2,2,0,"ba9c11e8-30f4-ea11-b882-24ee9a37d45c","The Academy of Urban Planning and Engineering - K552 - K480 - 32K552 - 400 IRVING AVENUE","b39c11e8-30f4-ea11-b882-24ee9a37d45c",-73911751,40696457,"BUSHWICK EDUCATIONAL CAMPUS - K","400 IRVING AVENUE"
3,2,1,"bd69c231-32f4-ea11-b882-24ee9a37d45c","P.S. 212 - Q212 - Q212 - 30Q212 - 34-25 82 STREET","b969c231-32f4-ea11-b882-24ee9a37d45c",-73884458,40753035,"P.S. 212 - QUEENS","34-25 82 STREET"
2,0,2,"ec201dab-30f4-ea11-b882-24ee9a37d45c","Pre-K Center at Bishop Ford School Site - K863 - K280 - 15K863 - 500 19 STREET","ed201dab-30f4-ea11-b882-24ee9a37d45c",-73983116,40656952,"PRE-K CENTER @ 500 19TH STREET - BROOKLYN","500 19 STREET"
3,2,1,"b82ff20c-32f4-ea11-b882-24ee9a37d45c","P.S. 108 Captain Vincent G. Fowler - Q108 - Q108 - 27Q108 - 108-10 109 AVENUE","b92ff20c-32f4-ea11-b882-24ee9a37d45c",-73831025,40679083,"P.S. 108 - QUEENS","108-10 109 AVENUE"
1,0,1,"6034aa92-31f4-ea11-b882-24ee9a37d45c","P.S. 138 - M138 - M380 - 75M138 - 508 WEST 153RD STREET","6134aa92-31f4-ea11-b882-24ee9a37d45c",-73944846,40830415,"P.S. 380- MANHATTAN","508 WEST 153RD STREET"
1,1,0,"db11f898-32f4-ea11-b882-24ee9a37d45c","Robert F. Wagner, Jr. Secondary School for Arts and Technology - Q560 - Q891 - 24Q560 - 47-07 30th Place","d911f898-32f4-ea11-b882-24ee9a37d45c",-73936442,40742217,"R. F. WAGNER SEC SCL ARTS & TECH-Q","47-07 30th Place"
3,3,0,"38c73b4a-32f4-ea11-b882-24ee9a37d45c","Corona Arts & Sciences Academy - Q311 - Q311 - 24Q311 - 98-11 44TH AVENUE","36c73b4a-32f4-ea11-b882-24ee9a37d45c",-73865239,40745920,"P.S./ I.S. 311 - QUEENS","98-11 44TH AVENUE"
1,1,0,"38005d7a-31f4-ea11-b882-24ee9a37d45c","J.H.S. 167 Robert F. Wagner - M167 - M167 - 02M167 - 220 EAST 76 STREET","39005d7a-31f4-ea11-b882-24ee9a37d45c",-73957827,40771541,"I.S. 167 - MANHATTAN","220 EAST 76 STREET"
9,8,1,"63ffcc6e-33f4-ea11-b882-24ee9a37d45c","The Bronx High School of Science - X445 - X445 - 10X445 - 75 WEST 205 STREET","64ffcc6e-33f4-ea11-b882-24ee9a37d45c",-73889011,40879958,"BRONX HS OF SCIENCE - X","75 WEST 205 STREET"
3,2,1,"0a9c4c1f-32f4-ea11-b882-24ee9a37d45c","P.S. 165 Edith K. Bergtraum - Q165 - Q165 - 25Q165 - 70-35 150 Street","0b9c4c1f-32f4-ea11-b882-24ee9a37d45c",-73816966,40729746,"P.S. 165 - QUEENS","70-35 150 Street"
3,0,3,"269ebaee-32f4-ea11-b882-24ee9a37d45c","P.S. X012 Lewis and Clark School - X012 - X012 - 75X012 - 2555 TRATMAN AVENUE","279ebaee-32f4-ea11-b882-24ee9a37d45c",-73844685,40840625,"P.S. 12 - BRONX","2555 TRATMAN AVENUE"
3,2,1,"7c977d2b-32f4-ea11-b882-24ee9a37d45c","P.S. 191 Mayflower - Q191 - Q191 - 26Q191 - 85-15 258 STREET","7b977d2b-32f4-ea11-b882-24ee9a37d45c",-73708617,40734266,"P.S. 191 - QUEENS","85-15 258 STREET"
1,0,1,"0f01adc5-83ef-eb11-b8b1-24ee9a37d45c","P.S. Q004 - Q004 - Q070 - 75Q004 - 30-44 43rd Street","7b2f77fa-31f4-ea11-b882-24ee9a37d45c",-73913964,40761762,"P.S. 70 - QUEENS","30-44 43rd Street"
1,1,0,"0bcf496e-31f4-ea11-b882-24ee9a37d45c","M.S. 131 - M131 - M131 - 02M131 - 100 HESTER STREET","03cf496e-31f4-ea11-b882-24ee9a37d45c",-73993607,40716231,"I.S. 131 - MANHATTAN","100 HESTER STREET"
1,0,1,"97778cb8-ebf6-ea11-b883-24ee9a37d459","Campus Magnet High Schools - Q490 - Q490 -  - 207- 01 116TH AVENUE","7ebc9674-32f4-ea11-b882-24ee9a37d45c",-73746330,40698786,"CAMPUS MAGNET HS (JACKSON) - Q","207- 01 116TH AVENUE"
1,1,0,"16a31781-33f4-ea11-b882-24ee9a37d45c","Bronx Leadership Academy II High School - X527 - X790 - 07X527 - 730 CONCOURSE VILLAGE WEST","0ea31781-33f4-ea11-b882-24ee9a37d45c",-73922366,40821828,"MOTT HAVEN EDUCATIONAL CAMPUS - BRONX","730 CONCOURSE VILLAGE WEST"
1,1,0,"08af0313-32f4-ea11-b882-24ee9a37d45c","P.S. 129 Patricia Larkin - Q129 - Q129 - 25Q129 - 128-02 7 Avenue","09af0313-32f4-ea11-b882-24ee9a37d45c",-73839505,40789926,"P.S. 129 - QUEENS","128-02 7 Avenue"
2,1,1,"f2ae0313-32f4-ea11-b882-24ee9a37d45c","P.S. 122 Mamie Fay - Q122 - Q122 - 30Q122 - 21-21 DITMARS BOULEVARD","cb2ff20c-32f4-ea11-b882-24ee9a37d45c",-73915785,40780507,"P.S. 122 - QUEENS","21-21 DITMARS BOULEVARD"
3,3,0,"80977d2b-32f4-ea11-b882-24ee9a37d45c","I.S. 192 The Linden - Q192 - Q192 - 29Q192 - 109-89 204 STREET","7f977d2b-32f4-ea11-b882-24ee9a37d45c",-73752885,40705989,"I.S. 192 - QUEENS","109-89 204 STREET"
5,2,3,"f59b4c1f-32f4-ea11-b882-24ee9a37d45c","P.S. 159 - Q159 - Q159 - 26Q159 - 205-01 33 AVENUE","f69b4c1f-32f4-ea11-b882-24ee9a37d45c",-73783973,40770108,"P.S. 159 - QUEENS","205-01 33 AVENUE"
2,2,0,"399ebaee-32f4-ea11-b882-24ee9a37d45c","P.S. 019 Judith K. Weiss - X019 - X019 - 11X019 - 311 East 237 Street","319ebaee-32f4-ea11-b882-24ee9a37d45c",-73866949,40899351,"P.S. 19 - BRONX","311 East 237 Street"
5,5,0,"8f977d2b-32f4-ea11-b882-24ee9a37d45c","P.S. 196 Grand Central Parkway - Q196 - Q196 - 28Q196 - 71-25 113 STREET","90977d2b-32f4-ea11-b882-24ee9a37d45c",-73837379,40722792,"P.S. 196 - QUEENS","71-25 113 STREET"
1,0,1,"f98ac007-ebf6-ea11-b883-24ee9a37d459","P.S. 723 - X723 - X701 - 75X723 - 3540 Bivona Street","aaeb0e7b-33f4-ea11-b882-24ee9a37d45c",-73831856,40882980,"P.S. 723 - BRONX","3540 Bivona Street"
7,7,0,"9748b1f5-eaf6-ea11-b883-24ee9a37d459","P.S. 372 -The Children's School - K372 - K834 - 75K372 - 512 CARROLL STREET","fcd7cf12-31f4-ea11-b882-24ee9a37d45c",-73985500,40676198,"P.S. 372 (OUR LADY OF PEACE)-K","512 CARROLL STREET"
5,2,3,"18f32ce2-31f4-ea11-b882-24ee9a37d45c","P.S. 019 Marino Jeantet - Q019 - Q019 - 24Q019 - 98-02 ROOSEVELT AVENUE","19f32ce2-31f4-ea11-b882-24ee9a37d45c",-73866557,40748600,"P.S. 19 - QUEENS","98-02 ROOSEVELT AVENUE"
1,1,0,"29a198c3-30f4-ea11-b882-24ee9a37d45c","P.S. 889 - K889 - K338 - 22K889 - 21 HINCKLEY PLACE","27a198c3-30f4-ea11-b882-24ee9a37d45c",-73971010,40644861,"P.S. 338 - Brooklyn","21 HINCKLEY PLACE"
2,1,1,"c7e0838c-31f4-ea11-b882-24ee9a37d45c","Battery Park City School - M276 - M276 - 02M276 - 55 BATTERY PLACE","c6e0838c-31f4-ea11-b882-24ee9a37d45c",-74017456,40706384,"P.S./I.S. 276 - MANHATTAN","55 BATTERY PLACE"
10,4,6,"698946f4-31f4-ea11-b882-24ee9a37d45c","P.S. 050 Talfourd Lawn Elementary School - Q050 - Q050 - 28Q050 - 143-26 101 AVENUE","6a8946f4-31f4-ea11-b882-24ee9a37d45c",-73806842,40694868,"P.S. 50 - QUEENS","143-26 101 AVENUE"
1,0,1,"09e0ede7-49fb-ea11-b883-24ee9a37d459","Williamsburg Y Head Start - KBWW - KBUN -  - 64 Division Avenue","0ae0ede7-49fb-ea11-b883-24ee9a37d459",0,0,"Williamsburg Y Head Start","64 Division Avenue"
2,1,1,"85283fb1-30f4-ea11-b882-24ee9a37d45c","J.H.S. 291 Roland Hayes - K291 - K291 - 32K291 - 231 PALMETTO STREET","83283fb1-30f4-ea11-b882-24ee9a37d45c",-73915217,40695875,"I.S. 291 - BROOKLYN","231 PALMETTO STREET"
2,2,0,"0ff32ce2-31f4-ea11-b882-24ee9a37d45c","P.S. 017 Henry David Thoreau - Q017 - Q017 - 30Q017 - 28-37 29 STREET","0af32ce2-31f4-ea11-b882-24ee9a37d45c",-73922544,40768034,"P.S. 17 - QUEENS","28-37 29 STREET"
3,3,0,"1c6e3d68-31f4-ea11-b882-24ee9a37d45c","P.S. 116 Mary Lindley Murray - M116 - M116 - 02M116 - 210 East 33 Street","1d6e3d68-31f4-ea11-b882-24ee9a37d45c",-73977906,40744511,"P.S. 116 - MANHATTAN","210 East 33 Street"
1,0,1,"673cbf01-ebf6-ea11-b883-24ee9a37d459","P.S. X596 - X596 - X178 - 75X596 - 850 BAYCHESTER AVENUE","e38a0044-33f4-ea11-b882-24ee9a37d45c",-73831669,40874035,"P.S. 178 - BRONX","850 BAYCHESTER AVENUE"
1,0,1,"a132c3fb-eaf6-ea11-b883-24ee9a37d459","P.S. 085 Judge Charles Vallone - Q085 - Q085 - 30Q085 - 23-70 31 STREET","0a7eed06-32f4-ea11-b882-24ee9a37d45c",-73915039,40773126,"P.S. 85 - QUEENS","23-70 31 STREET"
1,1,0,"1eb4977a-32f4-ea11-b882-24ee9a37d45c","Townsend Harris High School - Q525 - Q515 - 25Q525 - 149-11 MELBOURNE AVENUE","1db4977a-32f4-ea11-b882-24ee9a37d45c",-73821532,40737038,"TOWNSEND HARRIS HS - Q","149-11 MELBOURNE AVENUE"
4,0,4,"d9883319-32f4-ea11-b882-24ee9a37d45c","P.S. 143 Louis Armstrong - Q143 - Q143 - 24Q143 - 34-74 113 Street","d7883319-32f4-ea11-b882-24ee9a37d45c",-73855715,40755393,"P.S. 143 - QUEENS","34-74 113 Street"
3,2,1,"001bad3c-30f4-ea11-b882-24ee9a37d45c","Brooklyn Brownstone School - K628 - K035 - 16K628 - 272 Macdonough Street","fd1aad3c-30f4-ea11-b882-24ee9a37d45c",-73935891,40681528,"I.S. 35 - BROOKLYN","272 Macdonough Street"
7,5,2,"45e61462-31f4-ea11-b882-24ee9a37d45c","Bard High School Early College - M696 - M097 - 01M696 - 525 EAST HOUSTON STREET","46e61462-31f4-ea11-b882-24ee9a37d45c",-73976093,40718276,"BARD COLLEGE HS (OLD M097) - M","525 EAST HOUSTON STREET"
1,1,0,"1af92a2a-4afb-ea11-b883-24ee9a37d459","LONG XING DAY CARE CENTER, INC - KBQB - KBQB -  - 762 59TH STREET","1bf92a2a-4afb-ea11-b883-24ee9a37d459",-74009856,40636619,"LONG XING DAY CARE CENTER, INC.","762 59TH STREET"
2,1,1,"35005d7a-31f4-ea11-b882-24ee9a37d45c","P.S. 166 The Richard Rodgers School of The Arts and Technology - M166 - M166 - 03M166 - 132 WEST 89 STREET","36005d7a-31f4-ea11-b882-24ee9a37d45c",-73972557,40788925,"P.S. 166 - MANHATTAN","132 WEST 89 STREET"
2,1,1,"30e85c61-30f4-ea11-b882-24ee9a37d45c","P.S. 115 Daniel Mucatel School - K115 - K115 - 18K115 - 1500 East 92 Street","2fe85c61-30f4-ea11-b882-24ee9a37d45c",-73897896,40634861,"P.S. 115 - BROOKLYN","1500 East 92 Street"
4,4,0,"20a6ba98-31f4-ea11-b882-24ee9a37d45c","Academy for Software Engineering - M546 - M460 - 02M546 - 40 IRVING PLACE","16a6ba98-31f4-ea11-b882-24ee9a37d45c",-73987064,40735361,"WASHINGTON IRVING HS - MANHATTAN","40 IRVING PLACE"
2,0,2,"fbfb3df4-30f4-ea11-b882-24ee9a37d45c","Edward R. Murrow High School - K525 - K525 - 21K525 - 1600 AVENUE L","fafb3df4-30f4-ea11-b882-24ee9a37d45c",-73959141,40619671,"EDWARD R. MURROW HS - K","1600 AVENUE L"
1,1,0,"2bb4977a-32f4-ea11-b882-24ee9a37d45c","Queens High School of Teaching, Liberal Arts and the Sciences - Q566 - Q566 - 26Q566 - 74-20 COMMONWEALTH BLVD","27b4977a-32f4-ea11-b882-24ee9a37d45c",-73728834,40744197,"QNS HS OF TEACH., LIB. ARTS&SCI-Q","74-20 COMMONWEALTH BLVD"
2,2,0,"167eed06-32f4-ea11-b882-24ee9a37d45c","P.S. 088 Seneca - Q088 - Q088 - 24Q088 - 60-85 CATALPA AVENUE","177eed06-32f4-ea11-b882-24ee9a37d45c",-73896437,40704105,"P.S. 88 - QUEENS","60-85 CATALPA AVENUE"
6,1,5,"aefc24e8-31f4-ea11-b882-24ee9a37d45c","P.S. 021 Edward Hart - Q021 - Q021 - 25Q021 - 147-36 26 AVENUE","adfc24e8-31f4-ea11-b882-24ee9a37d45c",-73818581,40774134,"P.S. 21 - QUEENS","147-36 26 AVENUE"
3,1,2,"8b11b2e2-32f4-ea11-b882-24ee9a37d45c","Staten Island School of Civic Leadership - R861 - R861 - 31R861 - 280 REGIS DRIVE","8a11b2e2-32f4-ea11-b882-24ee9a37d45c",-74164427,40620310,"ELIZABETH A. CONNELLY CAMPUS - S.I.","280 REGIS DRIVE"
4,4,0,"45767649-31f4-ea11-b882-24ee9a37d45c","M.S. 255 Salk School of Science - M255 - M040 - 02M255 - 320 EAST 20TH STREET","46767649-31f4-ea11-b882-24ee9a37d45c",-73981536,40735328,"P.S. 40 - MANHATTAN","320 EAST 20TH STREET"
1,1,0,"840e6e25-32f4-ea11-b882-24ee9a37d45c","P.S. 169 Bay Terrace - Q169 - Q169 - 25Q169 - 18-25 212 STREET","820e6e25-32f4-ea11-b882-24ee9a37d45c",-73778430,40782331,"P.S. 169 - QUEENS","18-25 212 STREET"
1,0,1,"db8fd20d-ebf6-ea11-b883-24ee9a37d459","P.S. K771 - K771 - K014 - 75K771 - 2424 BATCHELDER STREET","eef57030-30f4-ea11-b882-24ee9a37d45c",-73938107,40593232,"I.S. 14 - BROOKLYN","2424 BATCHELDER STREET"
1,1,0,"8b32c3fb-eaf6-ea11-b883-24ee9a37d459","Teachers College Community School - M517 - M916 - 05M517 - 168 MORNINGSIDE AVENUE","f0ed94c3-31f4-ea11-b882-24ee9a37d45c",-73953317,40812428,"TEACHERS COLLEGE COMMUNITY SCHOOL - MANHATTAN","168 MORNINGSIDE AVENUE"
3,2,1,"969c11e8-30f4-ea11-b882-24ee9a37d45c","Park Slope Collegiate - K464 - K460 - 15K464 - 237 7 AVENUE","929c11e8-30f4-ea11-b882-24ee9a37d45c",-73978580,40669255,"John Jay Educational Campus","237 7 AVENUE"
1,0,1,"e4b36d80-30f4-ea11-b882-24ee9a37d45c","P.S. 192 - The Magnet School for Math and Science Inquiry - K192 - K192 - 20K192 - 4715 18 AVENUE","e5b36d80-30f4-ea11-b882-24ee9a37d45c",-73979540,40628800,"P.S. 192 - BROOKLYN","4715 18 AVENUE"
7,7,0,"b779df48-30f4-ea11-b882-24ee9a37d45c","P.S. 058 The Carroll - K058 - K058 - 15K058 - 330 SMITH STREET","b879df48-30f4-ea11-b882-24ee9a37d45c",-73995486,40680379,"P.S. 58 - BROOKLYN","330 SMITH STREET"
7,5,2,"340410ca-32f4-ea11-b882-24ee9a37d45c","The Barbara Esselborn School - R053 - R053 - 31R053 - 330 DURANT AVENUE","350410ca-32f4-ea11-b882-24ee9a37d45c",-74136640,40551926,"P.S. 53 - STATEN ISLAND","330 DURANT AVENUE"
2,1,1,"1a6e3d68-31f4-ea11-b882-24ee9a37d45c","P.S. 138 - M138 - M117 - 75M138 - 240 EAST 109 STREET","1b6e3d68-31f4-ea11-b882-24ee9a37d45c",-73942285,40792556,"J.H.S. 117 - MANHATTAN","240 EAST 109 STREET"
1,0,1,"e621d292-30f4-ea11-b882-24ee9a37d45c","P.S. K225 - The Eileen E. Zaglin - K225 - K225 - 21K225 - 1075 OCEAN VIEW AVENUE","e521d292-30f4-ea11-b882-24ee9a37d45c",-73955856,40580260,"P.S. 225 - BROOKLYN","1075 OCEAN VIEW AVENUE"
2,2,0,"9083ff9e-30f4-ea11-b882-24ee9a37d45c","P.S. 249 The Caton - K249 - K249 - 17K249 - 18 MARLBOROUGH ROAD","9183ff9e-30f4-ea11-b882-24ee9a37d45c",-73966456,40649509,"P.S. 249 - BROOKLYN","18 MARLBOROUGH ROAD"
3,2,1,"66b50aa5-30f4-ea11-b882-24ee9a37d45c","P.S. 261 Zipporiah Mills - K261 - K261 - 15K261 - 314 PACIFIC STREET","5fb50aa5-30f4-ea11-b882-24ee9a37d45c",-73988667,40687218,"P.S. 261 - BROOKLYN","314 PACIFIC STREET"
4,2,2,"9003194f-30f4-ea11-b882-24ee9a37d45c","J.H.S. 078 Roy H. Mann - K078 - K078 - 22K078 - 1420 EAST 68 STREET","8b03194f-30f4-ea11-b882-24ee9a37d45c",-73912914,40620537,"I.S. 78 - BROOKLYN","1420 EAST 68 STREET"
2,1,1,"14e85c61-30f4-ea11-b882-24ee9a37d45c","P.S. 110 The Monitor - K110 - K110 - 14K110 - 124 MONITOR STREET","e50d3c5b-30f4-ea11-b882-24ee9a37d45c",-73941926,40723743,"P.S. 110 - BROOKLYN","124 MONITOR STREET"
1,1,0,"ca92e6d5-30f4-ea11-b882-24ee9a37d45c","Academy of Innovative Technology - K618 - K420 - 19K618 - 999 JAMAICA AVENUE","c692e6d5-30f4-ea11-b882-24ee9a37d45c",-73869305,40693002,"FRANKLIN K. LANE HS - K","999 JAMAICA AVENUE"
1,0,1,"f302cefa-32f4-ea11-b882-24ee9a37d45c","P.S. 032 Belmont - X032 - X032 - 10X032 - 690 EAST 183 STREET","f402cefa-32f4-ea11-b882-24ee9a37d45c",-73886220,40851724,"P.S. 32 - BRONX","690 EAST 183 STREET"
2,0,2,"64bc9674-32f4-ea11-b882-24ee9a37d45c","Richmond Hill High School - Q475 - Q475 - 27Q475 - 89-30 114 Street","3002926e-32f4-ea11-b882-24ee9a37d45c",-73833815,40695171,"RICHMOND HILL HS - Q","89-30 114 Street"
1,0,1,"12af1f69-ebf6-ea11-b883-24ee9a37d459","District 2 Pre-K Center - M391 - M474 - 02M391 - 252 EAST 57 STREET","41a6ba98-31f4-ea11-b882-24ee9a37d45c",-73965878,40759081,"PRE-K CENTER @ EAST 57 STREET - MANHATTAN","252 EAST 57 STREET"
1,0,1,"1ae2abc9-30f4-ea11-b882-24ee9a37d45c","P.S. 380 John Wayne Elementary - K380 - K380 - 14K380 - 370 MARCY AVENUE","19e2abc9-30f4-ea11-b882-24ee9a37d45c",-73953702,40701790,"P.S. 380 - BROOKLYN","370 MARCY AVENUE"
2,2,0,"2da198c3-30f4-ea11-b882-24ee9a37d45c","P.S. 345 Patrolman Robert Bolden - K345 - K345 - 19K345 - 111 BERRIMAN STREET","2ca198c3-30f4-ea11-b882-24ee9a37d45c",-73879886,40676207,"P.S. 345 - BROOKLYN","111 BERRIMAN STREET"
2,0,2,"c08fd48d-ebf6-ea11-b883-24ee9a37d459","The Riverview School - Q277 - Q076 - 75Q277 - 36-36 10 Street","d2e8ce00-32f4-ea11-b882-24ee9a37d45c",-73941630,40760862,"P.S. 76 - QUEENS","36-36 10 Street"
2,1,1,"edc88e4f-31f4-ea11-b882-24ee9a37d45c","Inwood Early College for Health and Information Technologies - M211 - M052 - 06M211 - 650 ACADEMY STREET","e6c88e4f-31f4-ea11-b882-24ee9a37d45c",-73925464,40865556,"I.S. 52 - MANHATTAN","650 ACADEMY STREET"
1,1,0,"0f68ee1e-31f4-ea11-b882-24ee9a37d45c","P.S. 230 Doris L. Cohen - K230 - K908 - 15K230 - 425 Mcdonald Avenue","1068ee1e-31f4-ea11-b882-24ee9a37d45c",-73979161,40643512,"P.S. 230 ANNEX - BROOKLYN","425 Mcdonald Avenue"
3,1,2,"cc2ff20c-32f4-ea11-b882-24ee9a37d45c","The James J. Ambrose School - Q115 - Q115 - 26Q115 - 80-51 261 STREET","cd2ff20c-32f4-ea11-b882-24ee9a37d45c",-73709404,40744201,"The James J. Ambrose School","80-51 261 STREET"
5,4,1,"f721d292-30f4-ea11-b882-24ee9a37d45c","P.S. 230 Doris L. Cohen - K230 - K230 - 15K230 - 1 ALBEMARLE ROAD","f321d292-30f4-ea11-b882-24ee9a37d45c",-73980515,40645609,"P.S. 230 - BROOKLYN","1 ALBEMARLE ROAD"
13,8,5,"7107e99e-31f4-ea11-b882-24ee9a37d45c","Fiorello H. LaGuardia High School of Music & Art and Performing Arts - M485 - M485 - 03M485 - 100 Amsterdam Avenue","7207e99e-31f4-ea11-b882-24ee9a37d45c",-73985976,40774202,"FIORELLO LAGUARDIA HS - MANHATTAN","100 Amsterdam Avenue"
3,0,3,"4a416e00-31f4-ea11-b882-24ee9a37d45c","Brooklyn's Daily Discovery Pre-K Center - K840 - K687 - 21K840 - 10 BOUCK COURT","4b416e00-31f4-ea11-b882-24ee9a37d45c",-73973728,40588759,"PRE-K CENTER @BOUCK COURT - BROOKLYN","10 BOUCK COURT"
1,1,0,"0112a0be-ebf6-ea11-b883-24ee9a37d459","P.S. Q811 - Q811 - Q822 - 75Q811 - 114-36 202 STREET","12bef08c-32f4-ea11-b882-24ee9a37d45c",-73752694,40698940,"P.S. 811 MINISCHOOL (OLD 136 MN)-Q","114-36 202 STREET"
2,1,1,"bbbfa431-33f4-ea11-b882-24ee9a37d45c","The Laboratory School of Finance and Technology: X223 - X223 - X149 - 07X223 - 360 EAST 145 STREET","bcbfa431-33f4-ea11-b882-24ee9a37d45c",-73920851,40813612,"J.H.S. 149 - BRONX","360 EAST 145 STREET"
1,0,1,"92dc32dc-31f4-ea11-b882-24ee9a37d45c","P.S. 002 Alfred Zimberg - Q002 - Q002 - 30Q002 - 75-10 21 Avenue","93dc32dc-31f4-ea11-b882-24ee9a37d45c",-73894108,40769798,"P.S. 2 - QUEENS","75-10 21 Avenue"
1,1,0,"1970f999-ebf6-ea11-b883-24ee9a37d459","P.S. Q811 - Q811 - Q147 - 75Q811 - 218-01 116 Avenue","e6883319-32f4-ea11-b882-24ee9a37d45c",-73740140,40698028,"P.S. 147 - QUEENS","218-01 116 Avenue"
1,0,1,"1fa198c3-30f4-ea11-b882-24ee9a37d45c","Sunset Park Avenues Elementary School - K516 - K333 - 15K516 - 4222 4th Avenue","20a198c3-30f4-ea11-b882-24ee9a37d45c",-74008106,40650793,"P.S. 516 SUNSET PARK AVENUES ELEMENTARY SCHOOL - B","4222 4th Avenue"
1,0,1,"47042f6f-ebf6-ea11-b883-24ee9a37d459","District 2 Pre-K Center - M391 - M491 - 02M391 - 1683 THIRD AVENUE","c537fba4-31f4-ea11-b882-24ee9a37d45c",-73949807,40783981,"PRE-K CENTER @ 3RD AVENUE - MANHATTAN","1683 THIRD AVENUE"
11,11,0,"daf57030-30f4-ea11-b882-24ee9a37d45c","Magnet School of Math, Science and Design Technology - K010 - K010 - 15K010 - 511 7 AVENUE","dbf57030-30f4-ea11-b882-24ee9a37d45c",-73985946,40660912,"P.S. 10 - BROOKLYN","511 7 AVENUE"
2,2,0,"e0e0838c-31f4-ea11-b882-24ee9a37d45c","P.S. 051 Elias Howe - M051 - M338 - 02M051 - 525 WEST 44TH STREET","dfe0838c-31f4-ea11-b882-24ee9a37d45c",-73995825,40761487,"P.S. 51 ELIAS HOWE - MANHATTAN","525 WEST 44TH STREET"
13,13,0,"4c5b4cd6-32f4-ea11-b882-24ee9a37d45c","Staten Island Technical High School - R605 - R440 - 31R605 - 485 CLAWSON STREET","4b5b4cd6-32f4-ea11-b882-24ee9a37d45c",-74117086,40568299,"STATEN ISLAND TECHNICAL HS - S.I.","485 CLAWSON STREET"
2,1,1,"cb689025-33f4-ea11-b882-24ee9a37d45c","Soundview Academy for Culture and Scholarship - X448 - X131 - 08X448 - 885 Bolton Avenue","c8689025-33f4-ea11-b882-24ee9a37d45c",-73859998,40822925,"I.S. 131 - BRONX","885 Bolton Avenue"
2,0,2,"9ebfa431-33f4-ea11-b882-24ee9a37d45c","South Bronx International Middle School - X593 - X145 - 09X593 - 1000 TELLER AVENUE","9abfa431-33f4-ea11-b882-24ee9a37d45c",-73914067,40827438,"I.S. 145 - BRONX","1000 TELLER AVENUE"
3,3,0,"c7ba3c50-33f4-ea11-b882-24ee9a37d45c","P.S. 279 Captain Manuel Rivera, Jr. - X279 - X279 - 10X279 - 2100 WALTON AVENUE","c8ba3c50-33f4-ea11-b882-24ee9a37d45c",-73904958,40854666,"P.S. 279 - BRONX","2100 WALTON AVENUE"
2,0,2,"a73aa668-33f4-ea11-b882-24ee9a37d45c","High School for Teaching and the Professions - X433 - X430 - 10X433 - 2780 RESERVOIR AVENUE","a13aa668-33f4-ea11-b882-24ee9a37d45c",-73897066,40869061,"WALTON HS - X","2780 RESERVOIR AVENUE"
3,2,1,"5e8946f4-31f4-ea11-b882-24ee9a37d45c","P.S. 046 Alley Pond - Q046 - Q046 - 26Q046 - 64-45 218 STREET","5f8946f4-31f4-ea11-b882-24ee9a37d45c",-73758042,40745744,"P.S. 46 - QUEENS","64-45 218 STREET"
1,1,0,"237eed06-32f4-ea11-b882-24ee9a37d45c","I.S. 093 Ridgewood - Q093 - Q093 - 24Q093 - 66-56 FOREST AVENUE","0f7eed06-32f4-ea11-b882-24ee9a37d45c",-73903057,40705609,"I.S. 93 - QUEENS","66-56 FOREST AVENUE"
3,3,0,"a672c880-32f4-ea11-b882-24ee9a37d45c","Queens Metropolitan High School - Q686 - Q686 - 28Q686 - 91-30 METROPOLITAN AVENUE","a372c880-32f4-ea11-b882-24ee9a37d45c",-73855543,40708431,"METROPOLITAN AVENUE CAMPUS - QUEENS","91-30 METROPOLITAN AVENUE"
1,1,0,"ed9319d7-ebf6-ea11-b883-24ee9a37d459","South Richmond High School I.S./P.S. 25 - R025 - R450 - 75R025 - 105 HAMILTON AVENUE","5a5b4cd6-32f4-ea11-b882-24ee9a37d45c",-74082149,40645436,"CURTIS HS - S. I.","105 HAMILTON AVENUE"
1,1,0,"d78a0044-33f4-ea11-b882-24ee9a37d45c","Archimedes Academy for Math, Science and Technology Applications - X367 - X174 - 08X367 - 456 WHITE PLAINS ROAD","2a2ed53d-33f4-ea11-b882-24ee9a37d45c",-73856070,40815043,"I.S. 174 - BRONX","456 WHITE PLAINS ROAD"
2,2,0,"52767649-31f4-ea11-b882-24ee9a37d45c","P.S. 041 Greenwich Village - M041 - M041 - 02M041 - 116 WEST 11 STREET","53767649-31f4-ea11-b882-24ee9a37d45c",-73999094,40735450,"P.S. 41 - MANHATTAN","116 WEST 11 STREET"
2,0,2,"555bc58c-30f4-ea11-b882-24ee9a37d45c","P.S. 216 Arturo Toscanini - K216 - K216 - 21K216 - 350 AVENUE X","565bc58c-30f4-ea11-b882-24ee9a37d45c",-73969647,40590000,"P.S. 216 - BROOKLYN","350 AVENUE X"
5,5,0,"c5fab455-31f4-ea11-b882-24ee9a37d45c","East Side Community School - M450 - M060 - 01M450 - 420 East 12 Street","c1fab455-31f4-ea11-b882-24ee9a37d45c",-73982472,40729152,"J.H.S. 60 - MANHATTAN","420 East 12 Street"
1,1,0,"86c1797b-ebf6-ea11-b883-24ee9a37d459","P.S. M094 - M094 - M971 - 75M094 - 12 SPRUCE STREET","01ee94c3-31f4-ea11-b882-24ee9a37d45c",-74005473,40711321,"THE SPRUCE STREET EDUCATIONAL CAMPUS","12 SPRUCE STREET"
1,1,0,"1778931f-33f4-ea11-b882-24ee9a37d45c","Girls Preparatory Charter School of the Bronx - X487 - X120 - 84X487 - 890 CAULDWELL AVENUE","1478931f-33f4-ea11-b882-24ee9a37d45c",-73906739,40822291,"I.S. 301 - BRONX","890 CAULDWELL AVENUE"
2,2,0,"a69c11e8-30f4-ea11-b882-24ee9a37d45c","Science, Technology and Research Early College High School at Erasmus - K543 - K465 - 17K543 - 911 FLATBUSH AVENUE","9d9c11e8-30f4-ea11-b882-24ee9a37d45c",-73957173,40649602,"ERASMUS HALL CAMPUS - K","911 FLATBUSH AVENUE"
2,2,0,"3b0d6d19-33f4-ea11-b882-24ee9a37d45c","P.S. 106 Parkchester - X106 - X106 - 11X106 - 1514 OLMSTEAD AVENUE","3c0d6d19-33f4-ea11-b882-24ee9a37d45c",-73854823,40836974,"P.S. 106 - BRONX","1514 OLMSTEAD AVENUE"
1,1,0,"24e85c61-30f4-ea11-b882-24ee9a37d45c","M.S. 113 Ronald Edmonds Learning Center - K113 - K113 - 13K113 - 300 ADELPHI STREET","1fe85c61-30f4-ea11-b882-24ee9a37d45c",-73971474,40688769,"I.S. 113 - BROOKLYN","300 ADELPHI STREET"
1,0,1,"0206003e-32f4-ea11-b882-24ee9a37d45c","The Ivan Lafayette Early Childhood School of the Arts - Q228 - Q228 - 30Q228 - 32-63 93 STREET","0306003e-32f4-ea11-b882-24ee9a37d45c",-73874947,40756931,"P.S. 228 (ECC) - QUEENS","32-63 93 STREET"
1,1,0,"94a9d9c3-32f4-ea11-b882-24ee9a37d45c","P.S. 038 George Cromwell - R038 - R038 - 31R038 - 421 LINCOLN AVENUE","92a9d9c3-32f4-ea11-b882-24ee9a37d45c",-74099409,40574799,"P.S. 38 - STATEN ISLAND","421 LINCOLN AVENUE"
3,0,3,"5d9f4974-31f4-ea11-b882-24ee9a37d45c","P.S. 153 Adam Clayton Powell - M153 - M153 - 06M153 - 1750 AMSTERDAM AVENUE","589f4974-31f4-ea11-b882-24ee9a37d45c",-73947599,40826514,"P.S. 153 - MANHATTAN","1750 AMSTERDAM AVENUE"
2,1,1,"1baf0313-32f4-ea11-b882-24ee9a37d45c","The Bellaire School - Q135 - Q135 - 29Q135 - 207-11 89 AVENUE","1caf0313-32f4-ea11-b882-24ee9a37d45c",-73757591,40720864,"P.S. 135 - QUEENS","207-11 89 AVENUE"
2,1,1,"176e3d68-31f4-ea11-b882-24ee9a37d45c","KIPP NYC Washington Heights Academy Charter School - M068 - M115 - 84M068 - 586 WEST 177 STREET","166e3d68-31f4-ea11-b882-24ee9a37d45c",-73935140,40846116,"P.S. 115 - MANHATTAN","586 WEST 177 STREET"
1,0,1,"f01aad3c-30f4-ea11-b882-24ee9a37d45c","P.S. 031 Samuel F. Dupont - K031 - K031 - 14K031 - 75 MESEROLE AVENUE","f11aad3c-30f4-ea11-b882-24ee9a37d45c",-73954139,40726970,"P.S. 31 (OLD 126) - K","75 MESEROLE AVENUE"
4,2,2,"df968d36-30f4-ea11-b882-24ee9a37d45c","Brooklyn Arts and Science Elementary School - K705 - K022 - 17K705 - 443 ST MARKS AVENUE","e0968d36-30f4-ea11-b882-24ee9a37d45c",-73960093,40677100,"P.S. 22 - BROOKLYN","443 ST MARKS AVENUE"
2,2,0,"720c1bb1-31f4-ea11-b882-24ee9a37d45c","Harvey Milk High School - M586 - M807 - 02M586 - 2-10 ASTOR PLACE","710c1bb1-31f4-ea11-b882-24ee9a37d45c",-73992343,40729661,"HARVEY MILK SCHOOL - MANHATTAN","2-10 ASTOR PLACE"
4,3,1,"bd0d3c5b-30f4-ea11-b882-24ee9a37d45c","P.S. 094 The Henry Longfellow - K094 - K094 - 15K094 - 5010 6 AVENUE","8fd92255-30f4-ea11-b882-24ee9a37d45c",-74008795,40643730,"P.S. 94 - BROOKLYN","5010 6 AVENUE"
1,1,0,"ceb36d80-30f4-ea11-b882-24ee9a37d45c","P.S. 185 Walter Kassenbrock - K185 - K185 - 20K185 - 8601 RIDGE BOULEVARD","cfb36d80-30f4-ea11-b882-24ee9a37d45c",-74033429,40623598,"P.S. 185 - BROOKLYN","8601 RIDGE BOULEVARD"
1,0,1,"533cbf01-ebf6-ea11-b883-24ee9a37d459","South Richmond High School I.S./P.S. 25 - R025 - R825 - 75R025 - 6581 HYLAN BOULEVARD","77be7adc-32f4-ea11-b882-24ee9a37d45c",-74218688,40512019,"P.S. 25 (MOUNT LORETTO) - S.I.","6581 HYLAN BOULEVARD"
6,6,0,"5907e99e-31f4-ea11-b882-24ee9a37d45c","High School for Health Professions and Human Services - M420 - M475 - 02M420 - 345 East 15th Street","5607e99e-31f4-ea11-b882-24ee9a37d45c",-73982590,40732665,"HEALTH PROFESSIONS HS (OL STY) - M","345 East 15th Street"
2,0,2,"3bebaa73-30f4-ea11-b882-24ee9a37d45c","P.S. 748 Brooklyn School for Global Scholars - K748 - K163 - 20K748 - 1664 BENSON AVENUE","3cebaa73-30f4-ea11-b882-24ee9a37d45c",-74007469,40606739,"P.S. 163 - BROOKLYN","1664 BENSON AVENUE"
3,0,3,"7ed92255-30f4-ea11-b882-24ee9a37d45c","P.S. 90 Edna Cohen School - K090 - K090 - 21K090 - 2840 WEST 12 STREET","7dd92255-30f4-ea11-b882-24ee9a37d45c",-73980387,40578192,"P.S. 90 - BROOKLYN","2840 WEST 12 STREET"
3,0,3,"445bc58c-30f4-ea11-b882-24ee9a37d45c","P.S. 212 Lady Deborah Moody - K212 - K212 - 21K212 - 87 BAY 49 STREET","455bc58c-30f4-ea11-b882-24ee9a37d45c",-73985368,40587612,"P.S. 212 - BROOKLYN","87 BAY 49 STREET"
1,1,0,"6ce2635c-32f4-ea11-b882-24ee9a37d45c","Bayside High School - Q495 - Q405 - 26Q495 - 32-24 CORPORAL KENNEDY STREET","6be2635c-32f4-ea11-b882-24ee9a37d45c",-73781041,40771398,"BAYSIDE HS - Q","32-24 CORPORAL KENNEDY STREET"
3,0,3,"a932c3fb-eaf6-ea11-b883-24ee9a37d459","P.S. Q004 - Q004 - Q179 - 75Q004 - 196-25 Peck Avenue","9c0e6e25-32f4-ea11-b882-24ee9a37d45c",-73778118,40741700,"P.S. 179 - QUEENS","196-25 Peck Avenue"
2,0,2,"4fa10a44-32f4-ea11-b882-24ee9a37d45c","P.S./I.S. 268 - Q268 - Q268 - 29Q268 - 92-07 175 STREET","4ea10a44-32f4-ea11-b882-24ee9a37d45c",-73785210,40707648,"P.S. 268 - QUEENS","92-07 175 STREET"
1,1,0,"ea17b7f4-32f4-ea11-b882-24ee9a37d45c","P.S. 023 The New Children's School - X023 - X023 - 10X023 - 2151 WASHINGTON AVENUE","eb17b7f4-32f4-ea11-b882-24ee9a37d45c",-73894951,40853294,"P.S. 23 - BRONX","2151 WASHINGTON AVENUE"
1,0,1,"db92e6d5-30f4-ea11-b882-24ee9a37d45c","Academy for Young Writers - K404 - K422 - 19K404 - 1065 Elton Street","da92e6d5-30f4-ea11-b882-24ee9a37d45c",-73874064,40657266,"SPRING CREEK EDUCATIONAL CAMPUS - BROOKLYN","1065 Elton Street"
1,0,1,"dca2f813-ebf6-ea11-b883-24ee9a37d459","The Joan Snow Pre-K Center - K853 - K063 - 22K853 - 1340 EAST 29TH STREET","c879df48-30f4-ea11-b882-24ee9a37d45c",-73946330,40618450,"PRE-K CENTER @1340 EAST 29TH STREET - BROOKLYN","1340 EAST 29TH STREET"
7,7,0,"e437fba4-31f4-ea11-b882-24ee9a37d45c","Urban Assembly Maker Academy - M282 - M520 - 02M282 - 411 PEARL STREET","e037fba4-31f4-ea11-b882-24ee9a37d45c",-74000851,40711441,"MURRY BERGTRAUM HS (ECF) - M","411 PEARL STREET"
1,1,0,"369ebaee-32f4-ea11-b882-24ee9a37d45c","P.S. 018 John Peter Zenger - X018 - X018 - 07X018 - 502 MORRIS AVENUE","379ebaee-32f4-ea11-b882-24ee9a37d45c",-73922697,40816369,"P.S. 18 - BRONX","502 MORRIS AVENUE"
6,5,1,"a52aa42b-33f4-ea11-b882-24ee9a37d45c","Riverdale / Kingsbridge Academy (Middle School / High School 141) - X141 - X141 - 10X141 - 660 West 237 Street","a62aa42b-33f4-ea11-b882-24ee9a37d45c",-73914141,40887407,"M.S./H.S. 141 - BRONX","660 West 237 Street"
2,1,1,"848946f4-31f4-ea11-b882-24ee9a37d45c","P.S. 58 - The School of Heroes - Q058 - Q058 - 24Q058 - 72-24 GRAND AVENUE","808946f4-31f4-ea11-b882-24ee9a37d45c",-73890638,40728517,"P.S. 58 - QUEENS","72-24 GRAND AVENUE"
8,1,7,"e0d10307-33f4-ea11-b882-24ee9a37d45c","P.S. 066 School of Higher Expectations - X066 - X066 - 12X066 - 1001 JENNINGS STREET","ded10307-33f4-ea11-b882-24ee9a37d45c",-73886540,40831493,"P.S. 66 - BRONX","1001 JENNINGS STREET"
3,1,2,"d1b36d80-30f4-ea11-b882-24ee9a37d45c","P.S. 186 Dr. Irving A Gladstone - K186 - K186 - 20K186 - 7601 19 AVENUE","d2b36d80-30f4-ea11-b882-24ee9a37d45c",-73994258,40610917,"P.S. 186 - BROOKLYN","7601 19 AVENUE"
5,1,4,"515bc58c-30f4-ea11-b882-24ee9a37d45c","P.S. 215 Morris H. Weiss - K215 - K215 - 21K215 - 415 AVENUE S","505bc58c-30f4-ea11-b882-24ee9a37d45c",-73970171,40602722,"P.S. 215 - BROOKLYN","415 AVENUE S"
2,2,0,"2b0410ca-32f4-ea11-b882-24ee9a37d45c","P.S. 050 Frank Hankinson - R050 - R050 - 31R050 - 200 ADELAIDE AVENUE","2c0410ca-32f4-ea11-b882-24ee9a37d45c",-74124332,40560954,"P.S. 50 - STATEN ISLAND","200 ADELAIDE AVENUE"
1,0,1,"dac88e4f-31f4-ea11-b882-24ee9a37d45c","P.S. 048 P.O. Michael J. Buczek - M048 - M048 - 06M048 - 4360-78 BROADWAY","d9c88e4f-31f4-ea11-b882-24ee9a37d45c",-73933629,40853193,"P.S. 48 - MANHATTAN","4360-78 BROADWAY"
2,0,2,"23005d7a-31f4-ea11-b882-24ee9a37d45c","P.S. 161 Pedro Albizu Campos - M161 - M161 - 05M161 - 499 WEST 133 STREET","22005d7a-31f4-ea11-b882-24ee9a37d45c",-73952476,40817719,"P.S. 161 - MANHATTAN","499 WEST 133 STREET"
2,2,0,"64977d2b-32f4-ea11-b882-24ee9a37d45c","J.H.S. 185 Edward Bleeker - Q185 - Q185 - 25Q185 - 147-26 25 DRIVE","ae0e6e25-32f4-ea11-b882-24ee9a37d45c",-73818607,40774906,"J.H.S. 185 - QUEENS","147-26 25 DRIVE"
3,1,2,"cd8521d0-32f4-ea11-b882-24ee9a37d45c","I.S. 061 William A Morris - R061 - R061 - 31R061 - 445 CASTLETON AVENUE","460410ca-32f4-ea11-b882-24ee9a37d45c",-74097941,40634497,"I.S. 61 - STATEN ISLAND","445 CASTLETON AVENUE"
1,0,1,"2578931f-33f4-ea11-b882-24ee9a37d45c","J.H.S. 123 James M. Kieran - X123 - X123 - 08X123 - 1025 MORRISON AVENUE","2378931f-33f4-ea11-b882-24ee9a37d45c",-73874162,40824989,"I.S. 123 - BRONX","1025 MORRISON AVENUE"
1,0,1,"2d7c21b7-32f4-ea11-b882-24ee9a37d45c","P.S. 001 Tottenville - R001 - R001 - 31R001 - 58 SUMMIT STREET","2e7c21b7-32f4-ea11-b882-24ee9a37d45c",-74243950,40508638,"P.S. 1 - STATEN ISLAND","58 SUMMIT STREET"
3,2,1,"bab36d80-30f4-ea11-b882-24ee9a37d45c","The SEEALL Academy - K180 - K180 - 20K180 - 5601 16 AVENUE","b8b36d80-30f4-ea11-b882-24ee9a37d45c",-73989250,40626454,"P.S. 180 - BROOKLYN","5601 16 AVENUE"
1,1,0,"c3c88e4f-31f4-ea11-b882-24ee9a37d45c","The Anderson School - M334 - M044 - 03M334 - 100 WEST 77 STREET","bfc88e4f-31f4-ea11-b882-24ee9a37d45c",-73977602,40780536,"I.S. 44 - MANHATTAN","100 WEST 77 STREET"
8,2,6,"f6f57030-30f4-ea11-b882-24ee9a37d45c","P.S. 015 Patrick F. Daly - K015 - K015 - 15K015 - 71 SULLIVAN STREET","f5f57030-30f4-ea11-b882-24ee9a37d45c",-74011864,40677085,"P.S. 15 - BROOKLYN","71 SULLIVAN STREET"
1,1,0,"e3315367-30f4-ea11-b882-24ee9a37d45c","P.S. 138 Brooklyn - K138 - K138 - 17K138 - 760 PROSPECT PLACE","e4315367-30f4-ea11-b882-24ee9a37d45c",-73951559,40673943,"P.S. 138 - BROOKLYN","760 PROSPECT PLACE"
3,3,0,"8407e99e-31f4-ea11-b882-24ee9a37d45c","Manhattan / Hunter Science High School - M541 - M490 - 03M541 - 122 AMSTERDAM AVENUE","7c07e99e-31f4-ea11-b882-24ee9a37d45c",-73985608,40774891,"MARTIN LUTHER KING, JR. HS - M","122 AMSTERDAM AVENUE"
1,1,0,"9553dd74-33f4-ea11-b882-24ee9a37d45c","University Heights Secondary School - X495 - X470 - 07X495 - 701 ST. ANNS AVENUE","9253dd74-33f4-ea11-b882-24ee9a37d45c",-73911633,40818041,"SOUTH BRONX EDUCATIONAL CAMPUS (OLD 38) - X","701 ST. ANNS AVENUE"
3,3,0,"320b210d-33f4-ea11-b882-24ee9a37d45c","School for Environmental Citizenship - X386 - X079 - 10X386 - 125 EAST 181 STREET","2c0b210d-33f4-ea11-b882-24ee9a37d45c",-73903139,40855337,"P.S. 79 - BRONX","125 EAST 181 STREET"
1,1,0,"79bc9674-32f4-ea11-b882-24ee9a37d45c","Grover Cleveland High School - Q485 - Q487 - 24Q485 - 21-27 Himrod Street","7abc9674-32f4-ea11-b882-24ee9a37d45c",-73909202,40711881,"CLEVELAND AF NO. 1 - QUEENS","21-27 Himrod Street"
3,0,3,"197eed06-32f4-ea11-b882-24ee9a37d45c","P.S. 89Q: The Jose Peralta School of Dreamers - Q089 - Q089 - 24Q089 - 85-28 BRITTON AVENUE","1a7eed06-32f4-ea11-b882-24ee9a37d45c",-73879641,40745963,"P.S. 89 - QUEENS","85-28 BRITTON AVENUE"
2,2,0,"86eb6056-32f4-ea11-b882-24ee9a37d45c","The CIVIC School of Bayside Hills - Q390 - Q361 - 26Q390 - 56-10 214 Street","85eb6056-32f4-ea11-b882-24ee9a37d45c",-73764954,40749673,"P.S. @ 56-10 214 STREET - QUEENS","56-10 214 Street"
1,1,0,"555b4cd6-32f4-ea11-b882-24ee9a37d45c","Port Richmond High School - R445 - R445 - 31R445 - 85 ST JOSEPHS AVENUE","515b4cd6-32f4-ea11-b882-24ee9a37d45c",-74141924,40635562,"PORT RICHMOND HS - S. I.","85 ST JOSEPHS AVENUE"
2,1,1,"5ade5eb7-30f4-ea11-b882-24ee9a37d45c","P.S. 306 Ethan Allen - K306 - K306 - 19K306 - 970 VERMONT STREET","59de5eb7-30f4-ea11-b882-24ee9a37d45c",-73886620,40655340,"P.S. 306 - BROOKLYN","970 VERMONT STREET"
1,1,0,"7836d900-33f4-ea11-b882-24ee9a37d45c","P.S. 059 The Community School of Technology - X059 - X059 - 10X059 - 2185 BATHGATE AVENUE","7936d900-33f4-ea11-b882-24ee9a37d45c",-73893639,40853141,"P.S. 59 - BRONX","2185 BATHGATE AVENUE"
7,6,1,"87e2635c-32f4-ea11-b882-24ee9a37d45c","Benjamin N. Cardozo High School - Q415 - Q415 - 26Q415 - 57-00 223RD STREET","86e2635c-32f4-ea11-b882-24ee9a37d45c",-73757271,40752343,"BENJAMIN N. CARDOZO HS - Q","57-00 223RD STREET"
7,7,0,"59be7adc-32f4-ea11-b882-24ee9a37d45c","Susan E. Wagner High School - R460 - R460 - 31R460 - 1200 MANOR ROAD","5abe7adc-32f4-ea11-b882-24ee9a37d45c",-74130819,40588985,"SUSAN E. WAGNER HS - S. I.","1200 MANOR ROAD"
1,1,0,"410d6d19-33f4-ea11-b882-24ee9a37d45c","Mott Hall III - X128 - X110 - 09X128 - 580 CROTONA PARK SOUTH","420d6d19-33f4-ea11-b882-24ee9a37d45c",-73900654,40834470,"P.S. 110 - BRONX","580 CROTONA PARK SOUTH"
3,2,1,"8b476368-32f4-ea11-b882-24ee9a37d45c","Newtown High School - Q455 - Q455 - 24Q455 - 48-01 90 STREET","8c476368-32f4-ea11-b882-24ee9a37d45c",-73874129,40740824,"NEWTOWN HS - Q","48-01 90 STREET"
3,1,2,"e8d10307-33f4-ea11-b882-24ee9a37d45c","P.S. 068 Bronx - X068 - X068 - 11X068 - 4011 MONTICELLO AVENUE","e9d10307-33f4-ea11-b882-24ee9a37d45c",-73838880,40891603,"P.S. 68 - BRONX","4011 MONTICELLO AVENUE"
1,1,0,"546e70b7-31f4-ea11-b882-24ee9a37d45c","Millennium High School - M418 - M824 - 02M418 - 75 BROAD STREET","760c1bb1-31f4-ea11-b882-24ee9a37d45c",-74011202,40704697,"MILLENNIUM HS - MANHATTAN","75 BROAD STREET"
1,1,0,"6c2f77fa-31f4-ea11-b882-24ee9a37d45c","P.S. 064 Joseph P. Addabbo - Q064 - Q064 - 27Q064 - 82-01 101 AVENUE","6d2f77fa-31f4-ea11-b882-24ee9a37d45c",-73856956,40681901,"P.S. 64 - QUEENS","82-01 101 AVENUE"
3,3,0,"40b4977a-32f4-ea11-b882-24ee9a37d45c","Queens Technical High School - Q600 - Q600 - 24Q600 - 37-02 47 AVENUE","41b4977a-32f4-ea11-b882-24ee9a37d45c",-73927995,40741658,"QUEENS VOC HS - Q","37-02 47 AVENUE"
2,1,1,"f9b6c337-32f4-ea11-b882-24ee9a37d45c","P.S. 213 The Carl Ullman School - Q213 - Q213 - 26Q213 - 231-02 67 AVENUE","f8b6c337-32f4-ea11-b882-24ee9a37d45c",-73745390,40747457,"P.S. 213 - QUEENS","231-02 67 AVENUE"
1,1,0,"0618b7f4-32f4-ea11-b882-24ee9a37d45c","P.S./M.S. 029 Melrose School - X029 - X029 - 07X029 - 758 COURTLANDT AVENUE","0718b7f4-32f4-ea11-b882-24ee9a37d45c",-73916419,40821544,"P.S. 29 - BRONX","758 COURTLANDT AVENUE"
4,1,3,"f89b4c1f-32f4-ea11-b882-24ee9a37d45c","P.S. 160 Walter Francis Bishop - Q160 - Q160 - 28Q160 - 109-59 INWOOD STREET","ee9b4c1f-32f4-ea11-b882-24ee9a37d45c",-73799685,40688373,"P.S. 160 - QUEENS","109-59 INWOOD STREET"
5,5,0,"858d8486-31f4-ea11-b882-24ee9a37d45c","P.S. 199 Jessie Isador Straus - M199 - M199 - 03M199 - 270 WEST 70 STREET","868d8486-31f4-ea11-b882-24ee9a37d45c",-73984423,40777603,"P.S. 199 - MANHATTAN","270 WEST 70 STREET"
1,1,0,"9034aa92-31f4-ea11-b882-24ee9a37d45c","High School for Dual Language and Asian Studies - M545 - M445 - 02M545 - 350 GRAND STREET","8834aa92-31f4-ea11-b882-24ee9a37d45c",-73989329,40717329,"SEWARD PARK HS - MANHATTAN","350 GRAND STREET"
1,0,1,"84977d2b-32f4-ea11-b882-24ee9a37d45c","P.S. Q256 - Q256 - Q198 - 75Q256 - 3-65 BEACH 56 STREET","85977d2b-32f4-ea11-b882-24ee9a37d45c",-73786649,40594008,"I.S. 198 - QUEENS","3-65 BEACH 56 STREET"
1,0,1,"e8e0a4fb-ebf6-ea11-b883-24ee9a37d459","J. M. Rapport School Career Development - X754 - X362 - 75X754 - 921 EAST 228TH STREET","6ce03d56-33f4-ea11-b882-24ee9a37d45c",-73852714,40888242,"I.S./H.S. 362 - BRONX","921 EAST 228TH STREET"
2,0,2,"7907e99e-31f4-ea11-b882-24ee9a37d45c","Art and Design High School - M630 - M488 - 02M630 - 231-249 EAST 56 STREET","6d07e99e-31f4-ea11-b882-24ee9a37d45c",-73967204,40759248,"MIDTOWN EAST CAMPUS - MANHATTAN","231-249 EAST 56 STREET"
3,3,0,"136e3d68-31f4-ea11-b882-24ee9a37d45c","East Side Middle School - M114 - M114 - 02M114 - 331 EAST 91ST STREET","126e3d68-31f4-ea11-b882-24ee9a37d45c",-73947379,40780452,"EAST SIDE MIDDLE SCHOOL - MANHATTAN","331 EAST 91ST STREET"
3,2,1,"9cd810ab-31f4-ea11-b882-24ee9a37d45c","NYC iSchool - M376 - M615 - 02M376 - 131 AVENUE OF THE AMERICAS","9ad810ab-31f4-ea11-b882-24ee9a37d45c",-74005058,40724630,"CHELSEA VOC HS - MANHATTAN","131 AVENUE OF THE AMERICAS"
5,4,1,"7aa9d9c3-32f4-ea11-b882-24ee9a37d45c","P.S. 029 Bardwell - R029 - R029 - 31R029 - 1581 VICTORY BOULEVARD","7ba9d9c3-32f4-ea11-b882-24ee9a37d45c",-74116197,40614039,"P.S. 29 - STATEN ISLAND","1581 VICTORY BOULEVARD"
2,2,0,"270410ca-32f4-ea11-b882-24ee9a37d45c","The Eagle Academy for Young Men of Staten Island - R028 - R049 - 31R028 - 101 WARREN STREET","190410ca-32f4-ea11-b882-24ee9a37d45c",-74080695,40620443,"I.S. 49 - STATEN ISLAND","101 WARREN STREET"
1,0,1,"d4b36d80-30f4-ea11-b882-24ee9a37d45c","P.S. 188 Michael E. Berdy - K188 - K188 - 21K188 - 3314 Neptune Avenue","cdb36d80-30f4-ea11-b882-24ee9a37d45c",-74000489,40576733,"P.S. 188 - BROOKLYN","3314 Neptune Avenue"
5,1,4,"8f593c87-33f4-ea11-b882-24ee9a37d45c","P.S. 246 Poe Center - X246 - X843 - 10X246 - 2641 Grand Concourse","90593c87-33f4-ea11-b882-24ee9a37d45c",-73895300,40865972,"P.S. 246 (POE CENTER) - BRONX","2641 Grand Concourse"
1,1,0,"69c130ae-6c0c-ed11-b091-088e901ef405","P.S. X010 - X010 - X104 - 75X010 - 1449 SHAKESPEARE AVENUE","360d6d19-33f4-ea11-b882-24ee9a37d45c",-73920826,40843453,"P.S. 199 - BRONX","1449 SHAKESPEARE AVENUE"
12,10,2,"96e657bd-30f4-ea11-b882-24ee9a37d45c","P.S. 316 Elijah Stroud - K316 - K316 - 17K316 - 750 CLASSON AVENUE","94e657bd-30f4-ea11-b882-24ee9a37d45c",-73961418,40674685,"P.S. 316 - BROOKLYN","750 CLASSON AVENUE"
6,4,2,"f4201dab-30f4-ea11-b882-24ee9a37d45c","I.S. 281 Joseph B Cavallaro - K281 - K281 - 21K281 - 8787 24 AVENUE","f2201dab-30f4-ea11-b882-24ee9a37d45c",-73993565,40594648,"I.S. 281 - BROOKLYN","8787 24 AVENUE"
3,3,0,"778d8486-31f4-ea11-b882-24ee9a37d45c","KIPP Infinity Charter School - M336 - M195 - 84M336 - 625 WEST 133 STREET","758d8486-31f4-ea11-b882-24ee9a37d45c",-73956814,40819793,"TERENCE D. TOLBERT EDUCATION COMPLEX - MANHATTAN","625 WEST 133 STREET"
1,0,1,"befab455-31f4-ea11-b882-24ee9a37d45c","P.S. 035 - M035 - M058 - 75M035 - 317 WEST 52ND STREET","bafab455-31f4-ea11-b882-24ee9a37d45c",-73985899,40764129,"P.S. 35 (OLD 58/MNHT HS) - M","317 WEST 52ND STREET"
1,1,0,"5c2f77fa-31f4-ea11-b882-24ee9a37d45c","P.S. 060 Woodhaven - Q060 - Q060 - 27Q060 - 91-02 88 AVENUE","8e8946f4-31f4-ea11-b882-24ee9a37d45c",-73852792,40691467,"P.S. 60 - QUEENS","91-02 88 AVENUE"
3,3,0,"8c72c880-32f4-ea11-b882-24ee9a37d45c","Thomas A. Edison Career and Technical Education High School - Q620 - Q620 - 28Q620 - 165-65 84 AVENUE","49b4977a-32f4-ea11-b882-24ee9a37d45c",-73799692,40716071,"THOMAS A. EDISON VOC HS - Q","165-65 84 AVENUE"
5,3,2,"1f005d7a-31f4-ea11-b882-24ee9a37d45c","P.S. 158 Bayard Taylor - M158 - M158 - 02M158 - 1458 YORK AVENUE","1d005d7a-31f4-ea11-b882-24ee9a37d45c",-73950745,40770215,"P.S. 158 - MANHATTAN","1458 YORK AVENUE"
4,1,3,"ad32c3fb-eaf6-ea11-b883-24ee9a37d459","P.S. Q993 - Q993 - Q191 - 75Q993 - 85-15 258 STREET","7b977d2b-32f4-ea11-b882-24ee9a37d45c",-73708617,40734266,"P.S. 191 - QUEENS","85-15 258 STREET"
1,0,1,"60507380-31f4-ea11-b882-24ee9a37d45c","P.S. 138 - M138 - M189 - 75M138 - 2580 AMSTERDAM AVENUE","5f507380-31f4-ea11-b882-24ee9a37d45c",-73928048,40853045,"P.S. 189 - MANHATTAN","2580 AMSTERDAM AVENUE"
3,3,0,"2102926e-32f4-ea11-b882-24ee9a37d45c","Queens Collegiate: A College Board School - Q310 - Q470 - 28Q310 - 167-01 GOTHIC DRIVE","1f02926e-32f4-ea11-b882-24ee9a37d45c",-73798658,40714551,"JAMAICA HS - Q","167-01 GOTHIC DRIVE"
1,1,0,"7ca5db98-30f4-ea11-b882-24ee9a37d45c","P.S. 243K- The Weeksville School - K243 - K243 - 16K243 - 1580 DEAN STREET","7aa5db98-30f4-ea11-b882-24ee9a37d45c",-73935093,40675675,"P.S. 243 - BROOKLYN","1580 DEAN STREET"
1,0,1,"fa11a0be-ebf6-ea11-b883-24ee9a37d459","P.S. Q224 - Q224 - Q809 - 75Q224 - 221-21 Corbett Road","febdf08c-32f4-ea11-b882-24ee9a37d45c",-73763295,40770666,"P.S. 224 ANNEX - QUEENS","221-21 Corbett Road"
1,1,0,"692b3eee-30f4-ea11-b882-24ee9a37d45c","Franklin Delano Roosevelt High School - K505 - K505 - 20K505 - 5800 20 AVENUE","682b3eee-30f4-ea11-b882-24ee9a37d45c",-73982583,40621299,"FRANKLIN D. ROOSEVELT HS - K","5800 20 AVENUE"
4,2,2,"d0315367-30f4-ea11-b882-24ee9a37d45c","P.S. 128 Bensonhurst - K128 - K128 - 21K128 - 2075 84 STREET","d1315367-30f4-ea11-b882-24ee9a37d45c",-73995084,40604980,"P.S. 128 (TANDEM BROOKLYN STUDIO)","2075 84 STREET"
1,1,0,"ca8521d0-32f4-ea11-b882-24ee9a37d45c","P.S. 060 Alice Austen - R060 - R060 - 31R060 - 55 Merrill Avenue","cb8521d0-32f4-ea11-b882-24ee9a37d45c",-74162634,40610604,"P.S. 60 - STATEN ISLAND","55 Merrill Avenue"
3,2,1,"cd689025-33f4-ea11-b882-24ee9a37d45c","Success Academy Charter School - Bronx 4 - X464 - X131 - 84X464 - 885 Bolton Avenue","c8689025-33f4-ea11-b882-24ee9a37d45c",-73859998,40822925,"I.S. 131 - BRONX","885 Bolton Avenue"
6,2,4,"54ebaa73-30f4-ea11-b882-24ee9a37d45c","P.S. 169 Sunset Park - K169 - K169 - 15K169 - 4305 7 AVENUE","55ebaa73-30f4-ea11-b882-24ee9a37d45c",-74001700,40645825,"P.S. 169 - BROOKLYN","4305 7 AVENUE"
1,0,1,"7a74b5e8-48fb-ea11-b883-24ee9a37d459","BRIGHT KIDS GFDC CORP - FL1 - KCWN - KBAW -  - 167 MENAHAN STREET","7b74b5e8-48fb-ea11-b883-24ee9a37d459",-73919126,40696433,"167 MENAHAN STREET","167 MENAHAN STREET"
1,0,1,"1b04d718-31f4-ea11-b882-24ee9a37d45c","Success Academy Charter School - Flatbush - K886 - K884 - 84K886 - 15 Snyder Avenue","1c04d718-31f4-ea11-b882-24ee9a37d45c",-73957501,40648790,"EXPLORE CHARTER - K","15 Snyder Avenue"
2,2,0,"1f7eed06-32f4-ea11-b882-24ee9a37d45c","P.S. 091 Richard Arkwright - Q091 - Q091 - 24Q091 - 68-10 CENTRAL AVE","207eed06-32f4-ea11-b882-24ee9a37d45c",-73883995,40703503,"P.S. 91 - QUEENS","68-10 CENTRAL AVE"
3,1,2,"3ce61462-31f4-ea11-b882-24ee9a37d45c","Success Academy Charter School - Harlem 3 - M385 - M099 - 84M385 - 410 EAST 100 STREET","3de61462-31f4-ea11-b882-24ee9a37d45c",-73942154,40785107,"I.S. 99 - MANHATTAN","410 EAST 100 STREET"
1,0,1,"4febaa73-30f4-ea11-b882-24ee9a37d45c","New Bridges Elementary - K532 - K167 - 17K532 - 1025 EASTERN PARKWAY","4cebaa73-30f4-ea11-b882-24ee9a37d45c",-73934316,40669557,"P.S. 167 - BROOKLYN","1025 EASTERN PARKWAY"
3,3,0,"1c005d7a-31f4-ea11-b882-24ee9a37d45c","Yorkville East Middle School - M177 - M158 - 02M177 - 1458 YORK AVENUE","1d005d7a-31f4-ea11-b882-24ee9a37d45c",-73950745,40770215,"P.S. 158 - MANHATTAN","1458 YORK AVENUE"
3,3,0,"e7ba3c50-33f4-ea11-b882-24ee9a37d45c","P.S. 204 Morris Heights - X204 - X338 - 09X204 - 1780 Dr. Martin Luther King Jr. Blvd","e3ba3c50-33f4-ea11-b882-24ee9a37d45c",-73915217,40849416,"MORRIS HEIGHTS EDUCATIONAL COMPLEX - BRONX","1780 Dr. Martin Luther King Jr. Blvd"
1,0,1,"4a005d7a-31f4-ea11-b882-24ee9a37d45c","Success Academy Charter School - Harlem 5 - M482 - M175 - 84M482 - 175 WEST 134 STREET","47005d7a-31f4-ea11-b882-24ee9a37d45c",-73942706,40814388,"P.S. 175 - MANHATTAN","175 WEST 134 STREET"
1,0,1,"f92ece86-32f4-ea11-b882-24ee9a37d45c","Success Academy Charter School - South Jamaica - Q374 - Q781 - 84Q374 - 120-27 141st Street","fa2ece86-32f4-ea11-b882-24ee9a37d45c",-73799756,40675626,"John Adams HS Annex - Queens","120-27 141st Street"
3,2,1,"a072c880-32f4-ea11-b882-24ee9a37d45c","Young Women's Leadership School, Queens - Q896 - Q680 - 28Q896 - 150-91 87 ROAD","9d72c880-32f4-ea11-b882-24ee9a37d45c",-73804166,40708409,"YOUNG WOMENS' LEADERSHIP SCHOOL - QUEENS","150-91 87 ROAD"
1,0,1,"e9968d36-30f4-ea11-b882-24ee9a37d45c","Success Academy Charter School - Bed Stuy 3 - K883 - K025 - 84K883 - 787 LAFAYETTE AVENUE","ea968d36-30f4-ea11-b882-24ee9a37d45c",-73940749,40691472,"P.S. 25 - BROOKLYN","787 LAFAYETTE AVENUE"
1,0,1,"b1fab455-31f4-ea11-b882-24ee9a37d45c","J.H.S. 054 Booker T. Washington - M054 - M054 - 03M054 - 103 WEST 107 STREET","b2fab455-31f4-ea11-b882-24ee9a37d45c",-73963270,40800700,"I.S. 54 - MANHATTAN","103 WEST 107 STREET"
1,1,0,"0dd1de79-30f4-ea11-b882-24ee9a37d45c","P.S. 177 The Marlboro - K177 - K177 - 21K177 - 346 AVENUE P","0ed1de79-30f4-ea11-b882-24ee9a37d45c",-73974425,40608169,"P.S. 177 - BROOKLYN","346 AVENUE P"
2,1,1,"868946f4-31f4-ea11-b882-24ee9a37d45c","Success Academy Charter School - Springfield Gardens - New York 6 - Q339 - Q059 - 84Q339 - 132-55 RIDGEDALE STREET","878946f4-31f4-ea11-b882-24ee9a37d45c",-73752772,40681881,"I.S. 59 - QUEENS","132-55 RIDGEDALE STREET"
2,1,1,"3ba6ba98-31f4-ea11-b882-24ee9a37d45c","Success Academy Charter School - Upper West - M523 - M470 - 84M523 - 145 WEST 84 STREET","33a6ba98-31f4-ea11-b882-24ee9a37d45c",-73974483,40786134,"LOUIS D. BRANDEIS HS - MANHATTAN","145 WEST 84 STREET"
1,1,0,"db315367-30f4-ea11-b882-24ee9a37d45c","P.S. 132 The Conselyea School - K132 - K132 - 14K132 - 320 MANHATTAN AVENUE","dc315367-30f4-ea11-b882-24ee9a37d45c",-73945663,40714772,"P.S. 132 - BROOKLYN","320 MANHATTAN AVENUE"
2,2,0,"b7ab074a-33f4-ea11-b882-24ee9a37d45c","P.S./M.S. 194 - X194 - X194 - 11X194 - 2365 WATERBURY AVENUE","b6ab074a-33f4-ea11-b882-24ee9a37d45c",-73846594,40835410,"P.S./I.S. 194 - BRONX","2365 WATERBURY AVENUE"
1,0,1,"fcb98b86-30f4-ea11-b882-24ee9a37d45c","P.S. 199 Frederick Wachtel - K199 - K199 - 21K199 - 1100 ELM AVENUE","fdb98b86-30f4-ea11-b882-24ee9a37d45c",-73963026,40616310,"P.S. 199 - BROOKLYN","1100 ELM AVENUE"
2,0,2,"da9319d7-ebf6-ea11-b883-24ee9a37d459","P.S. R373 - R373 - R071 - 75R373 - 1050 Targee Street","db8521d0-32f4-ea11-b882-24ee9a37d45c",-74091239,40603492,"P.S./I.S. 48 - Staten Island","1050 Targee Street"
4,3,1,"8f11b2e2-32f4-ea11-b882-24ee9a37d45c","Bridge Preparatory Charter School - R076 - R880 - 84R076 - 715 OCEAN TERRACE","8e11b2e2-32f4-ea11-b882-24ee9a37d45c",-74105883,40607637,"P.S. 80 (PETR COMPL-BLDG B) - S.I.","715 OCEAN TERRACE"
5,2,3,"9eeb0e7b-33f4-ea11-b882-24ee9a37d45c","H.E.R.O. High (Health, Education, and Research Occupations High School) - X259 - X655 - 07X259 - 455 SOUTHERN BLVD","99eb0e7b-33f4-ea11-b882-24ee9a37d45c",-73907528,40810671,"SAMUEL GOMPERS VOC HS - X","455 SOUTHERN BLVD"
2,2,0,"8dd810ab-31f4-ea11-b882-24ee9a37d45c","Manhattan Bridges High School - M542 - M535 - 02M542 - 525 WEST 50TH STREET","f137fba4-31f4-ea11-b882-24ee9a37d45c",-73992700,40765474,"PARK WEST HS (ECF) - MANHATTAN","525 WEST 50TH STREET"
1,1,0,"d8315367-30f4-ea11-b882-24ee9a37d45c","P.S. 131 Brooklyn - K131 - K131 - 15K131 - 4305 FT HAMILTON PARKWAY","d9315367-30f4-ea11-b882-24ee9a37d45c",-73993247,40640728,"P.S. 131 - BROOKLYN","4305 FT HAMILTON PARKWAY"
3,3,0,"9d476368-32f4-ea11-b882-24ee9a37d45c","Queens High School for Language Studies - Q241 - Q460 - 25Q241 - 35-01 UNION STREET","97476368-32f4-ea11-b882-24ee9a37d45c",-73826811,40764892,"FLUSHING HS - Q","35-01 UNION STREET"
2,1,1,"89476368-32f4-ea11-b882-24ee9a37d45c","District 25 Pre-K Center - Q409 - Q454 - 25Q409 - 123-07 22nd Avenue","8a476368-32f4-ea11-b882-24ee9a37d45c",-73844811,40780363,"PRE-K CENTER @22ND AVENUE - QUEENS","123-07 22nd Avenue"
2,1,1,"d38521d0-32f4-ea11-b882-24ee9a37d45c","The Kathleen Grimm School for Leadership and Sustainability - R062 - R062 - 31R062 - 644 Bloomingdale Road","d48521d0-32f4-ea11-b882-24ee9a37d45c",-74217934,40541563,"K.GRIMM SCL FOR LDRSHP&SUSTAINABLTY@SANDY GR -S.I.","644 Bloomingdale Road"
3,3,0,"8de04648-53e6-eb11-b8b1-24ee9a37d45c","Success Academy Charter School - Bronx 3 - X380 - M043 - 84X380 - 509 WEST 129 STREET","59767649-31f4-ea11-b882-24ee9a37d45c",-73955520,40815747,"I.S. 172 (OLD 43) - MANHATTAN","509 WEST 129 STREET"
3,2,1,"c3e0838c-31f4-ea11-b882-24ee9a37d45c","P.S./I.S. 217 Roosevelt Island - M217 - M271 - 02M217 - 645 MAIN STREET","b8e0838c-31f4-ea11-b882-24ee9a37d45c",-73956435,40753598,"P.S./I.S. 217 - MANHATTAN","645 MAIN STREET"
1,1,0,"a8d810ab-31f4-ea11-b882-24ee9a37d45c","Success Academy Charter School - Hell's Kitchen - M170 - M625 - 84M170 - 439 WEST 49TH STREET","a9d810ab-31f4-ea11-b882-24ee9a37d45c",-73990318,40763655,"HS OF GRAPHIC COMMUNICATION ARTS-M","439 WEST 49TH STREET"
1,0,1,"3aa10a44-32f4-ea11-b882-24ee9a37d45c","P.S. 254 - The Rosa Parks School - Q254 - Q254 - 27Q254 - 84-40 101 STREET","39a10a44-32f4-ea11-b882-24ee9a37d45c",-73847886,40697200,"P.S. 254 - QUEENS","84-40 101 STREET"
4,1,3,"8041e65b-31f4-ea11-b882-24ee9a37d45c","The Bilingual Bicultural School - M182 - M083 - 04M182 - 219 East 109 Street","8141e65b-31f4-ea11-b882-24ee9a37d45c",-73941955,40793363,"P.S. 83 - MANHATTAN","219 East 109 Street"
2,1,1,"367eed06-32f4-ea11-b882-24ee9a37d45c","P.S. 099 Kew Gardens - Q099 - Q099 - 28Q099 - 82-37 KEW GARDENS ROAD","377eed06-32f4-ea11-b882-24ee9a37d45c",-73827722,40711502,"P.S. 99 - QUEENS","82-37 KEW GARDENS ROAD"
1,1,0,"fa201dab-30f4-ea11-b882-24ee9a37d45c","P.S. 282 Park Slope - K282 - K282 - 13K282 - 180 6 Avenue","f8201dab-30f4-ea11-b882-24ee9a37d45c",-73977983,40676649,"P.S. 282 - BROOKLYN","180 6 Avenue"
3,1,2,"c50d3c5b-30f4-ea11-b882-24ee9a37d45c","I.S. 096 Seth Low - K096 - K096 - 21K096 - 99 AVENUE P","c10d3c5b-30f4-ea11-b882-24ee9a37d45c",-73984985,40608135,"I.S. 96 - BROOKLYN","99 AVENUE P"
2,2,0,"b9edf392-32f4-ea11-b882-24ee9a37d45c","P.S. 099 Kew Gardens - Q099 - Q866 - 28Q099 - 83-34 Kew Gardens Road","baedf392-32f4-ea11-b882-24ee9a37d45c",-73827276,40709492,"P.S. 99 ANNEX - QUEENS","83-34 Kew Gardens Road"
2,0,2,"d2883319-32f4-ea11-b882-24ee9a37d45c","Queens Transition Center - Q752 - Q142 - 75Q752 - 142-10 LINDEN BOULEVARD","2eaf0313-32f4-ea11-b882-24ee9a37d45c",-73800875,40683473,"P.S. 752 (OLD J142) - QUEENS","142-10 LINDEN BOULEVARD"
1,1,0,"5a5bc58c-30f4-ea11-b882-24ee9a37d45c","School for Classics High School - K683 - K218 - 19K683 - 370 FOUNTAIN AVENUE","5b5bc58c-30f4-ea11-b882-24ee9a37d45c",-73874537,40670020,"I.S. 218 - BROOKLYN","370 FOUNTAIN AVENUE"
1,0,1,"3b3cbf01-ebf6-ea11-b883-24ee9a37d459","P.S. Q233 - Q233 - Q686 - 75Q233 - 91-30 METROPOLITAN AVENUE","a372c880-32f4-ea11-b882-24ee9a37d45c",-73855543,40708431,"METROPOLITAN AVENUE CAMPUS - QUEENS","91-30 METROPOLITAN AVENUE"
2,1,1,"4b6e70b7-31f4-ea11-b882-24ee9a37d45c","High School for Mathematics, Science and Engineering at City College - M692 - M812 - 05M692 - 240 CONVENT AVE","4c6e70b7-31f4-ea11-b882-24ee9a37d45c",-73950354,40820208,"HS FOR MATH, SCI & ENGINEERING-M","240 CONVENT AVE"
1,0,1,"1ea31781-33f4-ea11-b882-24ee9a37d45c","KIPP Academy Charter School - X704 - X790 - 84X704 - 730 CONCOURSE VILLAGE WEST","0ea31781-33f4-ea11-b882-24ee9a37d45c",-73922366,40821828,"MOTT HAVEN EDUCATIONAL CAMPUS - BRONX","730 CONCOURSE VILLAGE WEST"
4,1,3,"307eed06-32f4-ea11-b882-24ee9a37d45c","P.S. 097 Forest Park - Q097 - Q097 - 27Q097 - 85-52 85 STREET","317eed06-32f4-ea11-b882-24ee9a37d45c",-73860031,40694232,"P.S. 97 - QUEENS","85-52 85 STREET"
1,0,1,"5ef4a0ef-eaf6-ea11-b883-24ee9a37d459","P.S. K140 - K140 - K258 - 75K140 - 141 MACON STREET","b183ff9e-30f4-ea11-b882-24ee9a37d45c",-73945600,40681920,"I.S. 258 - BROOKLYN","141 MACON STREET"
1,0,1,"f0883319-32f4-ea11-b882-24ee9a37d45c","P.S. 148 Queens - Q148 - Q148 - 30Q148 - 89-02 32 AVENUE","ef883319-32f4-ea11-b882-24ee9a37d45c",-73878638,40757629,"P.S. 148 - QUEENS","89-02 32 AVENUE"
1,0,1,"7e886843-31f4-ea11-b882-24ee9a37d45c","P.S. 004 Duke Ellington - M004 - M004 - 06M004 - 500 WEST 160 STREET","7f886843-31f4-ea11-b882-24ee9a37d45c",-73941594,40834877,"P.S. 4 - MANHATTAN","500 WEST 160 STREET"
3,3,0,"1fb7c337-32f4-ea11-b882-24ee9a37d45c","J.H.S. 226 Virgil I. Grissom - Q226 - Q226 - 27Q226 - 121-10 ROCKAWAY BOULEVARD","1eb7c337-32f4-ea11-b882-24ee9a37d45c",-73816730,40675021,"I.S. 226 - QUEENS","121-10 ROCKAWAY BOULEVARD"
5,2,3,"4de61462-31f4-ea11-b882-24ee9a37d45c","Innovation Charter High School - M433 - M099 - 84M433 - 410 EAST 100 STREET","3de61462-31f4-ea11-b882-24ee9a37d45c",-73942154,40785107,"I.S. 99 - MANHATTAN","410 EAST 100 STREET"
2,2,0,"72283fb1-30f4-ea11-b882-24ee9a37d45c","Community Roots Charter School - K536 - K287 - 84K536 - 50 NAVY STREET","73283fb1-30f4-ea11-b882-24ee9a37d45c",-73981120,40697856,"P.S. 287 - BROOKLYN","50 NAVY STREET"
2,2,0,"5588e6db-30f4-ea11-b882-24ee9a37d45c","New Utrecht High School - K445 - K445 - 20K445 - 1601 80 STREET","5488e6db-30f4-ea11-b882-24ee9a37d45c",-74002308,40613041,"NEW UTRECHT HS - K","1601 80 STREET"
2,2,0,"52507380-31f4-ea11-b882-24ee9a37d45c","P.S. 183 Robert L. Stevenson - M183 - M183 - 02M183 - 419 East 66 Street","53507380-31f4-ea11-b882-24ee9a37d45c",-73957731,40763804,"P.S. 183 - MANHATTAN","419 East 66 Street"
1,1,0,"790e6e25-32f4-ea11-b882-24ee9a37d45c","P.S. 166 Henry Gradstein - Q166 - Q166 - 30Q166 - 33-09 35 AVENUE","7a0e6e25-32f4-ea11-b882-24ee9a37d45c",-73926249,40757497,"P.S. 166 - QUEENS","33-09 35 AVENUE"
2,1,1,"6107e99e-31f4-ea11-b882-24ee9a37d45c","Ella Baker School - M225 - M480 - 02M225 - 317 EAST 67 STREET","6007e99e-31f4-ea11-b882-24ee9a37d45c",-73959777,40765638,"JULIA RICHMAN ED. COMPLEX - M","317 EAST 67 STREET"
1,0,1,"917e21a6-ebf6-ea11-b883-24ee9a37d459","The Riverview School - Q277 - Q312 - 75Q277 - 46-08 5TH STREET","cf454b50-32f4-ea11-b882-24ee9a37d45c",-73955145,40747077,"P.S./.IS. 78 - QUEENS","46-08 5TH STREET"
3,1,2,"cc8442ee-31f4-ea11-b882-24ee9a37d45c","P.S. 033 Edward M. Funk - Q033 - Q033 - 29Q033 - 91-37 222 STREET","cd8442ee-31f4-ea11-b882-24ee9a37d45c",-73734102,40727172,"P.S. 33 - QUEENS","91-37 222 STREET"
2,1,1,"14af0313-32f4-ea11-b882-24ee9a37d45c","P.S. 133 Queens - Q133 - Q133 - 26Q133 - 248-05 86 AVENUE","15af0313-32f4-ea11-b882-24ee9a37d45c",-73717819,40732458,"P.S. 133 - QUEENS","248-05 86 AVENUE"
1,0,1,"9a886843-31f4-ea11-b882-24ee9a37d45c","Frederick Douglass Academy - M499 - M010 - 05M499 - 2581 7TH AVENUE","9b886843-31f4-ea11-b882-24ee9a37d45c",-73935746,40823988,"I.S. 10 (TANDEM M200) - MANHATTAN","2581 7TH AVENUE"
3,1,2,"912aa42b-33f4-ea11-b882-24ee9a37d45c","The Angelo Patri Middle School - X391 - X137 - 10X391 - 2225 WEBSTER AVENUE","8e2aa42b-33f4-ea11-b882-24ee9a37d45c",-73897404,40854257,"I.S. 391 (UDC) - BRONX","2225 WEBSTER AVENUE"
3,1,2,"47a10a44-32f4-ea11-b882-24ee9a37d45c","P.S./I.S. 295 - Q295 - Q263 - 29Q295 - 222-14 JAMAICA AVENUE","41a10a44-32f4-ea11-b882-24ee9a37d45c",-73731398,40720617,"P.S. /I.S 295 - QUEENS","222-14 JAMAICA AVENUE"
1,1,0,"400410ca-32f4-ea11-b882-24ee9a37d45c","P.S. 057 Hubert H. Humphrey - R057 - R057 - 31R057 - 140 PALMA DRIVE","410410ca-32f4-ea11-b882-24ee9a37d45c",-74083799,40611136,"P.S. 57 - STATEN ISLAND","140 PALMA DRIVE"
2,0,2,"ec09e2e1-30f4-ea11-b882-24ee9a37d45c","East Williamsburg Scholars Academy - K477 - K450 - 14K477 - 850 GRAND STREET","e909e2e1-30f4-ea11-b882-24ee9a37d45c",-73938921,40711134,"GRAND STREET CAMPUS (OLD E.D.HS)- K","850 GRAND STREET"
3,3,0,"f1454b50-32f4-ea11-b882-24ee9a37d45c","East Elmhurst Community School - Q329 - Q329 - 30Q329 - 26-25 97th Street","f0454b50-32f4-ea11-b882-24ee9a37d45c",-73872244,40761573,"EAST ELMHURST COMMUNITY SCHOOL - QUEENS","26-25 97th Street"
1,1,0,"d28442ee-31f4-ea11-b882-24ee9a37d45c","P.S. 035 Nathaniel Woodhull - Q035 - Q035 - 29Q035 - 90-01 191 Street","bb8442ee-31f4-ea11-b882-24ee9a37d45c",-73768894,40713438,"P.S. 35 - QUEENS","191-02 90 Avenue"
5,4,1,"29b7c337-32f4-ea11-b882-24ee9a37d45c","I.S. 227 Louis Armstrong - Q227 - Q227 - 30Q227 - 32-02 JUNCTION BOULEVARD","27b7c337-32f4-ea11-b882-24ee9a37d45c",-73874614,40757567,"I.S. 227 - QUEENS","32-02 JUNCTION BOULEVARD"
5,2,3,"9f6b4ae9-ea40-ec11-b8c3-24ee9a37d45c","KIPP Bronx Charter School II - X616 - XCHO - 84X616 - 501 Gerard Avenue","a06b4ae9-ea40-ec11-b8c3-24ee9a37d45c",-73929502,40818347,"501 Gerard Avenue","501 Gerard Avenue"
1,0,1,"668946f4-31f4-ea11-b882-24ee9a37d45c","P.S. 049 Dorothy Bonawit Kole - Q049 - Q049 - 24Q049 - 63-60 80th Street","678946f4-31f4-ea11-b882-24ee9a37d45c",-73875493,40719567,"P.S./I.S. 49 - QUEENS","63-60 80th Street"
1,0,1,"d9e0a4fb-ebf6-ea11-b883-24ee9a37d459","P.S. 723 - X723 - X189 - 75X723 - 3441 STEENWICK AVENUE","018b0044-33f4-ea11-b882-24ee9a37d45c",-73830616,40882778,"P.S./I.S. 189 - BRONX","3441 STEENWICK AVENUE"
1,0,1,"dd8a0044-33f4-ea11-b882-24ee9a37d45c","P.S. 175 City Island - X175 - X175 - 11X175 - 200 CITY ISLAND AVENUE","de8a0044-33f4-ea11-b882-24ee9a37d45c",-73783540,40844353,"P.S. 175 - BRONX","200 CITY ISLAND AVENUE"
3,2,1,"0dba8b86-30f4-ea11-b882-24ee9a37d45c","P.S. 204 Vince Lombardi - K204 - K204 - 20K204 - 8101 15 AVENUE","0eba8b86-30f4-ea11-b882-24ee9a37d45c",-74006137,40613535,"P.S. 204 - BROOKLYN","8101 15 AVENUE"
1,0,1,"8932c3fb-eaf6-ea11-b883-24ee9a37d459","P.S. 018 Park Terrace - M018 - M898 - 06M018 - 4124 9 Avenue","93c280bd-31f4-ea11-b882-24ee9a37d45c",-73911732,40871456,"P.S. 18 - MANHATTAN","4124 9 Avenue"
1,1,0,"240b210d-33f4-ea11-b882-24ee9a37d45c","P.S. 076 The Bennington School - X076 - X076 - 11X076 - 900 ADEE AVENUE","250b210d-33f4-ea11-b882-24ee9a37d45c",-73860928,40869059,"P.S. 76 - BRONX","900 ADEE AVENUE"
1,1,0,"b22ff20c-32f4-ea11-b882-24ee9a37d45c","Lighthouse Elementary School - Q106 - Q106 - 27Q106 - 180 BEACH 35 STREET","b32ff20c-32f4-ea11-b882-24ee9a37d45c",-73766846,40594738,"P.S. 106 - QUEENS","180 BEACH 35 STREET"
1,0,1,"58fdc1bd-32f4-ea11-b882-24ee9a37d45c","Fort Hill Collaborative Elementary School - R010 - R016 - 31R010 - 195 DANIEL LOW TERRACE","56fdc1bd-32f4-ea11-b882-24ee9a37d45c",-74079594,40639638,"P.S. 16 - STATEN ISLAND","195 DANIEL LOW TERRACE"
1,1,0,"419587f5-ebf6-ea11-b883-24ee9a37d459","P.S. X596 - X596 - X153 - 75X596 - 650 BAYCHESTER AVENUE","6801ce37-33f4-ea11-b882-24ee9a37d45c",-73831669,40874035,"P.S. 153 - BRONX","650 BAYCHESTER AVENUE"
1,1,0,"0ea198c3-30f4-ea11-b882-24ee9a37d45c","P.S. 328 Phyllis Wheatley - K328 - K328 - 19K328 - 330 ALABAMA AVENUE","0ca198c3-30f4-ea11-b882-24ee9a37d45c",-73898249,40667985,"P.S. 328 - BROOKLYN","330 ALABAMA AVENUE"
1,1,0,"96d91731-31f4-ea11-b882-24ee9a37d45c","Brooklyn Urban Garden Charter School - K758 - KBNU - 84K758 - 500 19 Street","97d91731-31f4-ea11-b882-24ee9a37d45c",-73982624,40656202,"STANLEY LAMM INSTITUE PRE-SCHOOL OF LONGISLAND HO","500 19 Street"
4,1,3,"fcae0313-32f4-ea11-b882-24ee9a37d45c","I.S. 125 Thom J. McCann Woodside - Q125 - Q125 - 24Q125 - 46-02 47 AVENUE","fdae0313-32f4-ea11-b882-24ee9a37d45c",-73918762,40740452,"I.S. 125 - QUEENS","46-02 47 AVENUE"
2,0,2,"daaeb707-ecf6-ea11-b883-24ee9a37d459","P.S. X017 - X017 - X450 - 75X017 - 1980 LAFAYETTE AVENUE","62ffcc6e-33f4-ea11-b882-24ee9a37d45c",-73855930,40821218,"Adlai E. Stevenson Educational Campus","1980 LAFAYETTE AVENUE"
1,1,0,"24e2abc9-30f4-ea11-b882-24ee9a37d45c","KIPP Always Mentally Prepared Charter School - K357 - K390 - 84K357 - 1224 PARK PLACE","25e2abc9-30f4-ea11-b882-24ee9a37d45c",-73937601,40672290,"I.S. 390 - BROOKLYN","1224 PARK PLACE"
1,0,1,"a82aa42b-33f4-ea11-b882-24ee9a37d45c","Bronx Alliance Middle School - X355 - X142 - 11X355 - 3750 BAYCHESTER AVENUE","a32aa42b-33f4-ea11-b882-24ee9a37d45c",-73839682,40886002,"I.S. 142 - BRONX","3750 BAYCHESTER AVENUE"
2,0,2,"8341e65b-31f4-ea11-b882-24ee9a37d45c","P.S. 083 Luis Munoz Rivera - M083 - M083 - 04M083 - 219 East 109 Street","8141e65b-31f4-ea11-b882-24ee9a37d45c",-73941955,40793363,"P.S. 83 - MANHATTAN","219 East 109 Street"
1,1,0,"dbfab455-31f4-ea11-b882-24ee9a37d45c","Tompkins Square Middle School - M839 - M064 - 01M839 - 600 EAST 6 STREET","d3fab455-31f4-ea11-b882-24ee9a37d45c",-73981597,40723130,"P.S. 64 (OLD 71) - MANHATTAN","600 EAST 6 STREET"
2,1,1,"df17b7f4-32f4-ea11-b882-24ee9a37d45c","P.S. 021 Philip H. Sheridan - X021 - X021 - 11X021 - 715 EAST 225 STREET","e017b7f4-32f4-ea11-b882-24ee9a37d45c",-73859420,40887888,"P.S. 21 - BRONX","715 EAST 225 STREET"
1,0,1,"fd8a0044-33f4-ea11-b882-24ee9a37d45c","Jill Chaifetz Transfer High School - X379 - X184 - 07X379 - 778 FOREST AVENUE","f88a0044-33f4-ea11-b882-24ee9a37d45c",-73905389,40818703,"I.S. 184 - BRONX","778 FOREST AVENUE"
3,3,0,"a332c3fb-eaf6-ea11-b883-24ee9a37d459","P.S. 131 Abigail Adams - Q131 - Q131 - 29Q131 - 170-21 84 Avenue","0eaf0313-32f4-ea11-b882-24ee9a37d45c",-73794061,40717150,"P.S. 131 - QUEENS","170-21 84 Avenue"
1,0,1,"e89b4c1f-32f4-ea11-b882-24ee9a37d45c","P.S. 155 - Q155 - Q155 - 27Q155 - 130-02 115 AVENUE","e99b4c1f-32f4-ea11-b882-24ee9a37d45c",-73810067,40679105,"P.S. 155 - QUEENS","130-02 115 AVENUE"
1,1,0,"1168ee1e-31f4-ea11-b882-24ee9a37d45c","P.S. 373 - Brooklyn Transition Center - K373 - K909 - 75K373 - 561 GRAND AVENUE","1268ee1e-31f4-ea11-b882-24ee9a37d45c",-73961636,40678591,"ACORN COMMUNITY HS - K","561 GRAND AVENUE"
1,1,0,"55a5db98-30f4-ea11-b882-24ee9a37d45c","J.H.S. 234 Arthur W. Cunningham - K234 - K234 - 22K234 - 1875 EAST 17 STREET","56a5db98-30f4-ea11-b882-24ee9a37d45c",-73955217,40604447,"I.S. 234 - BROOKLYN","1875 EAST 17 STREET"
1,1,0,"2b7becf3-49fb-ea11-b883-24ee9a37d459","GUILD PRESCHOOL - KBAI - KBAI -  - 1273 57TH STREET","2c7becf3-49fb-ea11-b883-24ee9a37d459",-73996847,40630871,"GUILD FOR EXCEPTIONAL CHILDREN","1273 57TH STREET"
1,1,0,"9b53dd74-33f4-ea11-b882-24ee9a37d45c","Bronx School of Law and Finance - X284 - X475 - 10X284 - 99 TERRACE VIEW AVENUE","9853dd74-33f4-ea11-b882-24ee9a37d45c",-73912686,40877379,"JOHN F. KENNEDY HS - X","99 TERRACE VIEW AVENUE"
1,0,1,"c0e0838c-31f4-ea11-b882-24ee9a37d45c","East Side Elementary School, PS 267 - M267 - M267 - 02M267 - 213 EAST 63RD STREET","c1e0838c-31f4-ea11-b882-24ee9a37d45c",-73963861,40763883,"P.S. 59 - (MEETH) -MANHATTAN","213 EAST 63RD STREET"
1,1,0,"cf2ff20c-32f4-ea11-b882-24ee9a37d45c","P.S./I.S. 116 William C. Hughley - Q116 - Q116 - 29Q116 - 107-25 WREN PLACE","d02ff20c-32f4-ea11-b882-24ee9a37d45c",-73781839,40700840,"P.S. 116 - QUEENS","107-25 WREN PLACE"
1,1,0,"7c34aa92-31f4-ea11-b882-24ee9a37d45c","Landmark High School - M419 - M440 - 02M419 - 351 WEST 18 STREET","7834aa92-31f4-ea11-b882-24ee9a37d45c",-74002540,40743407,"BAYARD RUSTIN EDUCATIONAL COMP-M","351 WEST 18 STREET"
1,1,0,"2d7eed06-32f4-ea11-b882-24ee9a37d45c","P.S. 096 - Q096 - Q096 - 27Q096 - 130-01 ROCKAWAY BOULEVARD","2e7eed06-32f4-ea11-b882-24ee9a37d45c",-73808128,40675369,"P.S. 96 - QUEENS","130-01 ROCKAWAY BOULEVARD"
1,1,0,"c837fba4-31f4-ea11-b882-24ee9a37d45c","Park East High School - M495 - M495 - 04M495 - 230 EAST 105 STREET","c737fba4-31f4-ea11-b882-24ee9a37d45c",-73944092,40790191,"PARK EAST HS - MANHATTAN","230 EAST 105 STREET"
1,0,1,"730067b2-ebf6-ea11-b883-24ee9a37d459","District 27 Pre-K Center - Q336 - Q468 - 27Q336 - 100-02 ROCKAWAY BOULEVARD","1d02926e-32f4-ea11-b882-24ee9a37d45c",-73838902,40679438,"3K CENTER @ 100-02 ROCKAWAY BOULEVARD - QUEENS","100-02 ROCKAWAY BOULEVARD"
2,1,1,"01f32ce2-31f4-ea11-b882-24ee9a37d45c","P.S. 012 James B. Colgate - Q012 - Q012 - 24Q012 - 42-00 72 STREET","02f32ce2-31f4-ea11-b882-24ee9a37d45c",-73893466,40742284,"P.S. 12 - QUEENS","42-00 72 STREET"
7,4,3,"c98442ee-31f4-ea11-b882-24ee9a37d45c","P.S. 032 State Street - Q032 - Q032 - 25Q032 - 171-11 35 AVENUE","ca8442ee-31f4-ea11-b882-24ee9a37d45c",-73794323,40765459,"P.S. 32 - QUEENS","171-11 35 AVENUE"
3,1,2,"252ed53d-33f4-ea11-b882-24ee9a37d45c","P.S. 011 Highbridge - X011 - X172 - 09X011 - 1399 Ogden Ave","262ed53d-33f4-ea11-b882-24ee9a37d45c",-73924626,40842407,"P.S. 11 ANNEX (P172 ECC) - BRONX","1399 Ogden Ave"
2,0,2,"7fa78d44-ebf6-ea11-b883-24ee9a37d459","The Little Brooklyn Pre-K Center - K767 - K661 - 15K767 - 219 25 Street","41416e00-31f4-ea11-b882-24ee9a37d45c",-73997034,40660159,"PRE-K CENTER @25TH STREET - BROOKLYN","219 25 Street"
1,0,1,"239ebaee-32f4-ea11-b882-24ee9a37d45c","P.S. 011 Highbridge - X011 - X011 - 09X011 - 1257 OGDEN AVENUE","249ebaee-32f4-ea11-b882-24ee9a37d45c",-73925890,40839693,"P.S. 11 - BRONX","1257 OGDEN AVENUE"
1,1,0,"47474313-33f4-ea11-b882-24ee9a37d45c","Bronx Envision Academy - X511 - X098 - 12X511 - 1619 BOSTON ROAD","3c474313-33f4-ea11-b882-24ee9a37d45c",-73890591,40836245,"I.S. 98 - BRONX","1619 BOSTON ROAD"
2,2,0,"559d7c62-33f4-ea11-b882-24ee9a37d45c","The Metropolitan Soundview High School - X521 - X420 - 12X521 - 1300 BOYNTON AVENUE","519d7c62-33f4-ea11-b882-24ee9a37d45c",-73878191,40832508,"JAMES MONROE EDUCATIONAL CAMPUS - X","1300 BOYNTON AVENUE"
1,0,1,"82f4a0ef-eaf6-ea11-b883-24ee9a37d459","The Little Brooklyn Pre-K Center - K767 - K749 - 15K767 - 173-177 25TH STREET","492f7d06-31f4-ea11-b882-24ee9a37d45c",-73998973,40661059,"PRE-K CENTER @25TH STREET - BROOKLYN","173-177 25TH STREET"
2,1,1,"b03fce93-7c88-ec11-b8d0-24ee9a37d45c","Academy of American Studies - Q575 - Q575 - 30Q575 - 40-11 28th Street","b13fce93-7c88-ec11-b8d0-24ee9a37d45c",-73936596,40751839,"ACADEMY OF AMERICAN STUDIES - QUEENS","40-11 28th Street"
8,2,6,"74a9d9c3-32f4-ea11-b882-24ee9a37d45c","P.S. 026 The Carteret School - R026 - R026 - 31R026 - 4108 VICTORY BOULEVARD","75a9d9c3-32f4-ea11-b882-24ee9a37d45c",-74190093,40591546,"P.S. 26 - STATEN ISLAND","4108 VICTORY BOULEVARD"
3,0,3,"dc8521d0-32f4-ea11-b882-24ee9a37d45c","P.S. 069 Daniel D. Tompkins - R069 - R069 - 31R069 - 144 KEATING PLACE","dd8521d0-32f4-ea11-b882-24ee9a37d45c",-74157327,40591480,"P.S. 69 - STATEN ISLAND","144 KEATING PLACE"
1,1,0,"dced94c3-31f4-ea11-b882-24ee9a37d45c","Ballet Tech, NYC Public School for Dance - M442 - M905 - 02M442 - 890 BROADWAY","daed94c3-31f4-ea11-b882-24ee9a37d45c",-73989481,40738521,"BALLET TECH/PUB. SCL FOR DANCE - M","890 BROADWAY"
1,0,1,"c617ab87-ebf6-ea11-b883-24ee9a37d459","P.S. Q233 - Q233 - Q025 - 75Q233 - 34-65 192 STREET","befc24e8-31f4-ea11-b882-24ee9a37d45c",-73789365,40764884,"J.H.S. 25 - QUEENS","34-65 192 STREET"
1,1,0,"c7d27c6d-30f4-ea11-b882-24ee9a37d45c","Success Academy Charter School - Prospect Heights - K756 - K138 - 84K756 - 760 PROSPECT PLACE","e4315367-30f4-ea11-b882-24ee9a37d45c",-73951559,40673943,"P.S. 138 - BROOKLYN","760 PROSPECT PLACE"
2,0,2,"77a9d9c3-32f4-ea11-b882-24ee9a37d45c","I.S. 027 Anning S. Prall - R027 - R027 - 31R027 - 11 CLOVE LAKE PLACE","78a9d9c3-32f4-ea11-b882-24ee9a37d45c",-74117818,40628291,"I.S. 27 - STATEN ISLAND","11 CLOVE LAKE PLACE"
3,3,0,"347c21b7-32f4-ea11-b882-24ee9a37d45c","P.S. 003 The Margaret Gioiosa School - R003 - R003 - 31R003 - 80 SOUTH GOFF AVENUE","357c21b7-32f4-ea11-b882-24ee9a37d45c",-74211850,40520812,"P.S. 3 - STATEN ISLAND","80 SOUTH GOFF AVENUE"
1,0,1,"469587f5-ebf6-ea11-b883-24ee9a37d459","P.S. X017 - X017 - X156 - 75X017 - 750 CONCOURSE VILLAGE WEST","8001ce37-33f4-ea11-b882-24ee9a37d45c",-73922527,40823014,"P.S. 156 - BRONX","750 CONCOURSE VILLAGE WEST"
1,0,1,"3a767649-31f4-ea11-b882-24ee9a37d45c","P.S. 028 Wright Brothers - M028 - M028 - 06M028 - 475 WEST 155 STREET","3b767649-31f4-ea11-b882-24ee9a37d45c",-73942023,40831630,"P.S. 28 - MANHATTAN","475 WEST 155 STREET"
11,9,2,"4e9d7c62-33f4-ea11-b882-24ee9a37d45c","Pelham Preparatory Academy - X542 - X415 - 11X542 - 925 ASTOR AVENUE","439d7c62-33f4-ea11-b882-24ee9a37d45c",-73860729,40860443,"CHRISTOPHER COLUMBUS HS - X","925 ASTOR AVENUE"
2,2,0,"43fdc1bd-32f4-ea11-b882-24ee9a37d45c","I.S. 007 Elias Bernstein - R007 - R007 - 31R007 - 1270 Huguenot Avenue","447c21b7-32f4-ea11-b882-24ee9a37d45c",-74186096,40522971,"I.S. 7 - STATEN ISLAND","1270 Huguenot Avenue"
1,1,0,"489d7c62-33f4-ea11-b882-24ee9a37d45c","Astor Collegiate Academy - X299 - X415 - 11X299 - 925 ASTOR AVENUE","439d7c62-33f4-ea11-b882-24ee9a37d45c",-73860729,40860443,"CHRISTOPHER COLUMBUS HS - X","925 ASTOR AVENUE"
1,1,0,"89886843-31f4-ea11-b882-24ee9a37d45c","P.S. 005 Ellen Lurie - M005 - M005 - 06M005 - 3703 TENTH AVENUE","8a886843-31f4-ea11-b882-24ee9a37d45c",-73922277,40857633,"P.S. 5 - MANHATTAN","3703 TENTH AVENUE"
1,0,1,"693cbf01-ebf6-ea11-b883-24ee9a37d459","P.S. X017 - X017 - X184 - 75X017 - 778 FOREST AVENUE","f88a0044-33f4-ea11-b882-24ee9a37d45c",-73905389,40818703,"I.S. 184 - BRONX","778 FOREST AVENUE"
8,3,5,"2e0410ca-32f4-ea11-b882-24ee9a37d45c","I.S. 051 Edwin Markham - R051 - R051 - 31R051 - 80 WILLOWBROOK ROAD","2f0410ca-32f4-ea11-b882-24ee9a37d45c",-74145522,40623077,"I.S. 51 - STATEN ISLAND","80 WILLOWBROOK ROAD"
1,1,0,"5d3cbf01-ebf6-ea11-b883-24ee9a37d459","P.S. 087 Bronx - X087 - X087 - 11X087 - 1935 BUSSING AVENUE","510b210d-33f4-ea11-b882-24ee9a37d45c",-73846198,40895741,"P.S. 87 - BRONX","1935 BUSSING AVENUE"
1,0,1,"aafc24e8-31f4-ea11-b882-24ee9a37d45c","P.S. 020 John Bowne - Q020 - Q020 - 25Q020 - 142-30 BARCLAY AVENUE","14f32ce2-31f4-ea11-b882-24ee9a37d45c",-73824388,40758347,"P.S. 20 - QUEENS","142-30 BARCLAY AVENUE"
1,0,1,"c762c807-f014-ec11-b8b5-24ee9a37d45c","Restart Academy - M973 - M025 - 79M973 - 145 Stanton Street","29767649-31f4-ea11-b882-24ee9a37d45c",-73986038,40720040,"J.H.S. 25 - MANHATTAN","145 Stanton Street"
2,2,0,"45474313-33f4-ea11-b882-24ee9a37d45c","Explorations Academy H.S. - X251 - X098 - 12X251 - 1619 BOSTON ROAD","3c474313-33f4-ea11-b882-24ee9a37d45c",-73890591,40836245,"I.S. 98 - BRONX","1619 BOSTON ROAD"
1,1,0,"857eda5c-ebf6-ea11-b883-24ee9a37d459","P.S. M226 - M226 - M076 - 75M226 - 220 WEST 121 STREET","7241e65b-31f4-ea11-b882-24ee9a37d45c",-73951451,40806534,"P.S. 76 - MANHATTAN","220 WEST 121 STREET"
5,3,2,"35ebaa73-30f4-ea11-b882-24ee9a37d45c","P.S. 164 Caesar Rodney - K164 - K164 - 20K164 - 4211 14 AVENUE","36ebaa73-30f4-ea11-b882-24ee9a37d45c",-73985739,40637101,"P.S. 164 - BROOKLYN","4211 14 AVENUE"
1,0,1,"9f53dd74-33f4-ea11-b882-24ee9a37d45c","Marble Hill High School for International Studies - X477 - X475 - 10X477 - 99 TERRACE VIEW AVENUE","9853dd74-33f4-ea11-b882-24ee9a37d45c",-73912686,40877379,"JOHN F. KENNEDY HS - X","99 TERRACE VIEW AVENUE"
1,0,1,"440b210d-33f4-ea11-b882-24ee9a37d45c","I.S. 232 - X232 - X082 - 09X232 - 1700 MACOMBS ROAD","3f0b210d-33f4-ea11-b882-24ee9a37d45c",-73915217,40849416,"I.S. 232 - BRONX","1700 MACOMBS ROAD"
4,4,0,"f6d10307-33f4-ea11-b882-24ee9a37d45c","P.S. 072 Dr. William Dorney - X072 - X072 - 08X072 - 2951 DEWEY AVENUE","f4d10307-33f4-ea11-b882-24ee9a37d45c",-73818172,40823237,"P.S. 72 - BRONX","2951 DEWEY AVENUE"
1,1,0,"290b210d-33f4-ea11-b882-24ee9a37d45c","P.S. 196 - X196 - X077 - 12X196 - 1250 WARD AVENUE","230b210d-33f4-ea11-b882-24ee9a37d45c",-73877305,40830811,"P.S. 195 - BRONX","1250 WARD AVENUE"
2,1,1,"568946f4-31f4-ea11-b882-24ee9a37d45c","P.S. 043 - Q043 - Q043 - 27Q043 - 160 BEACH 29 STREET","ee8442ee-31f4-ea11-b882-24ee9a37d45c",-73761086,40593480,"P.S. 43 - QUEENS","160 BEACH 29 STREET"
1,1,0,"18e63126-ebf6-ea11-b883-24ee9a37d459","P.S. K771 - K771 - K236 - 75K771 - 6302 AVENUE U","5ba5db98-30f4-ea11-b882-24ee9a37d45c",-73912005,40615494,"P.S. 236 - BROOKLYN","6302 AVENUE U"
2,2,0,"fd8ac007-ebf6-ea11-b883-24ee9a37d459","KIPP Freedom Charter School - X598 - X859 - 84X598 - 2246 JEROME AVENUE","a3593c87-33f4-ea11-b882-24ee9a37d45c",-73903764,40857932,"P.S. 315 - BRONX","2246 JEROME AVENUE"
2,2,0,"1eaf0313-32f4-ea11-b882-24ee9a37d45c","P.S. 136 Roy Wilkins - Q136 - Q136 - 29Q136 - 201-15 115 AVENUE","1faf0313-32f4-ea11-b882-24ee9a37d45c",-73752694,40698940,"P.S. 136 - QUEENS","201-15 115 AVENUE"
1,0,1,"6636d900-33f4-ea11-b882-24ee9a37d45c","P.S./I.S. 54 - X054 - X054 - 10X054 - 2703 WEBSTER AVENUE","6736d900-33f4-ea11-b882-24ee9a37d45c",-73887940,40864872,"P.S. 54 - BRONX","2703 WEBSTER AVENUE"
3,2,1,"db2ff20c-32f4-ea11-b882-24ee9a37d45c","P.S. 120 Queens - Q120 - Q120 - 25Q120 - 58-01 136 STREET","dc2ff20c-32f4-ea11-b882-24ee9a37d45c",-73828674,40745215,"P.S. 120 - QUEENS","58-01 136 STREET"
1,1,0,"e4201dab-30f4-ea11-b882-24ee9a37d45c","P.S. 277 Gerritsen Beach - K277 - K277 - 22K277 - 2529 GERRITSEN AVENUE","e5201dab-30f4-ea11-b882-24ee9a37d45c",-73927850,40595798,"P.S. 277 - BROOKLYN","2529 GERRITSEN AVENUE"
1,1,0,"9d69c231-32f4-ea11-b882-24ee9a37d45c","P.S. 203 Oakland Gardens - Q203 - Q203 - 26Q203 - 53-11 SPRINGFIELD BOULEVARD","9e69c231-32f4-ea11-b882-24ee9a37d45c",-73759822,40753606,"P.S. 203 - QUEENS","53-11 SPRINGFIELD BOULEVARD"
2,1,1,"417c21b7-32f4-ea11-b882-24ee9a37d45c","P.S. 6 Corporal Allan F. Kivlehan School - R006 - R006 - 31R006 - 555 PAGE AVENUE","3c7c21b7-32f4-ea11-b882-24ee9a37d45c",-74230118,40510207,"P.S. 6 - STATEN ISLAND","555 PAGE AVENUE"
1,1,0,"7bb37701-f57b-ed11-b0c6-088e901ef405","Saint Margaret Catholic Academy - QAGB - QAGB -  - 66-10 80 STREET","7cb37701-f57b-ed11-b0c6-088e901ef405",-73872514,40715573,"SAINT MARGARET SCHOOL","66-10 80 STREET"
3,1,2,"e6b98b86-30f4-ea11-b882-24ee9a37d45c","P.S. 193 Gil Hodges - K193 - K193 - 22K193 - 2515 AVENUE L","e5b98b86-30f4-ea11-b882-24ee9a37d45c",-73950321,40622080,"P.S. 193 - BROOKLYN","2515 AVENUE L"
3,2,1,"5f6e70b7-31f4-ea11-b882-24ee9a37d45c","High School of Economics and Finance - M489 - M833 - 02M489 - 100 TRINITY PLACE","606e70b7-31f4-ea11-b882-24ee9a37d45c",-74012328,40709270,"HS FOR ECONOMICS & FINANCE - M","100 TRINITY PLACE"
7,3,4,"50fdc1bd-32f4-ea11-b882-24ee9a37d45c","P.S. 013 M. L. Lindemeyer - R013 - R013 - 31R013 - 191 VERMONT AVENUE","51fdc1bd-32f4-ea11-b882-24ee9a37d45c",-74068963,40613322,"P.S. 13 - STATEN ISLAND","191 VERMONT AVENUE"
2,0,2,"499587f5-ebf6-ea11-b883-24ee9a37d459","P.S. X017 - X017 - X161 - 75X017 - 628 TINTON AVENUE","ff2dd53d-33f4-ea11-b882-24ee9a37d45c",-73905233,40814168,"P.S. 161 - BRONX","628 TINTON AVENUE"
2,1,1,"53ffcc6e-33f4-ea11-b882-24ee9a37d45c","World View High School - X353 - X440 - 10X353 - 100 WEST MOSHOLU PARKWAY SOUTH","4cffcc6e-33f4-ea11-b882-24ee9a37d45c",-73889011,40879958,"DEWITT CLINTON HS - X","100 WEST MOSHOLU PARKWAY SOUTH"
1,1,0,"209ebaee-32f4-ea11-b882-24ee9a37d45c","P.S. X015 Institute for Environmental Learning - X015 - X015 - 10X015 - 2195 ANDREWS AVENUE","219ebaee-32f4-ea11-b882-24ee9a37d45c",-73909763,40859243,"P.S. 15 - BRONX","2195 ANDREWS AVENUE"
1,0,1,"d28fd20d-ebf6-ea11-b883-24ee9a37d459","P.S. K140 - K140 - K005 - 75K140 - 820 HANCOCK STREET","edc1392a-30f4-ea11-b882-24ee9a37d45c",-73921970,40685241,"P.S. 5 - BROOKLYN","820 HANCOCK STREET"
1,0,1,"d6454b50-32f4-ea11-b882-24ee9a37d45c","The Children's Lab School - Q343 - Q313 - 24Q343 - 45-45 42ND STREET","d7454b50-32f4-ea11-b882-24ee9a37d45c",-73922604,40742580,"THE WALTER MCCAFFREY CAMPUS - QUEENS","45-45 42ND STREET"
7,3,4,"520b210d-33f4-ea11-b882-24ee9a37d45c","P.S. 085 Great Expectations - X085 - X085 - 10X085 - 2400 MARION AVENUE","530b210d-33f4-ea11-b882-24ee9a37d45c",-73894682,40858689,"P.S. 85 - BRONX","2400 MARION AVENUE"
1,1,0,"2e005d7a-31f4-ea11-b882-24ee9a37d45c","Mott Hall II - M862 - M165 - 03M862 - 234 West 109 Street","2f005d7a-31f4-ea11-b882-24ee9a37d45c",-73965949,40802653,"P.S. 165 - MANHATTAN","234 West 109 Street"
3,1,2,"1c7becf3-49fb-ea11-b883-24ee9a37d459","Cassidy's Place - MABK - MABK -  - 419 EAST 86 STREET","1d7becf3-49fb-ea11-b883-24ee9a37d459",-73948393,40776766,"CASSIDY'S PLACE","419 EAST 86 STREET"
1,1,0,"47fdc1bd-32f4-ea11-b882-24ee9a37d45c","P.S. 8 Shirlee Solomon - R008 - R008 - 31R008 - 112 LINDENWOOD ROAD","48fdc1bd-32f4-ea11-b882-24ee9a37d45c",-74152212,40547567,"P.S. 8 - STATEN ISLAND","112 LINDENWOOD ROAD"
3,3,0,"a16b4ae9-ea40-ec11-b8c3-24ee9a37d45c","KIPP Bronx Charter School III - X617 - XCHO - 84X617 - 501 Gerard Avenue","a06b4ae9-ea40-ec11-b8c3-24ee9a37d45c",-73929502,40818347,"501 Gerard Avenue","501 Gerard Avenue"
1,1,0,"3a0410ca-32f4-ea11-b882-24ee9a37d45c","P.S. 055 Henry M. Boehm - R055 - R055 - 31R055 - 54 OSBORNE STREET","3b0410ca-32f4-ea11-b882-24ee9a37d45c",-74163037,40536625,"P.S. 55 - STATEN ISLAND","54 OSBORNE STREET"
1,0,1,"1e0b210d-33f4-ea11-b882-24ee9a37d45c","The Vida Bogart School for All Children - X352 - X075 - 75X352 - 984 FAILE STREET","1f0b210d-33f4-ea11-b882-24ee9a37d45c",-73888948,40822314,"P.S. 75 - BRONX","984 FAILE STREET"
3,3,0,"e72ece86-32f4-ea11-b882-24ee9a37d45c","Civic Leadership Academy - Q293 - Q744 - 24Q293 - 45-10 94th Street","e22ece86-32f4-ea11-b882-24ee9a37d45c",-73871505,40743228,"ELMHURST EDUCATIONAL CAMPUS - Q","45-10 94th Street"
1,1,0,"f6fb3df4-30f4-ea11-b882-24ee9a37d45c","Brooklyn Frontiers High School - K423 - K520 - 15K423 - 112 SCHERMERHORN STREET","f7fb3df4-30f4-ea11-b882-24ee9a37d45c",-73989369,40690007,"PACIFIC ALT HS - K","112 SCHERMERHORN STREET"
1,1,0,"d79b4c1f-32f4-ea11-b882-24ee9a37d45c","P.S. 150 Queens - Q150 - Q150 - 30Q150 - 40-01 43 AVENUE","d89b4c1f-32f4-ea11-b882-24ee9a37d45c",-73923375,40745887,"P.S. 150 - QUEENS","40-01 43 AVENUE"
1,1,0,"039c4c1f-32f4-ea11-b882-24ee9a37d45c","P.S. 163 Flushing Heights - Q163 - Q163 - 25Q163 - 159-01 59 AVENUE","049c4c1f-32f4-ea11-b882-24ee9a37d45c",-73808765,40741107,"P.S. 163 - QUEENS","159-01 59 AVENUE"
2,1,1,"433cbf01-ebf6-ea11-b883-24ee9a37d459","P.S. Q811 - Q811 - Q811 - 75Q811 - 61-25 MARATHON PARKWAY","08bef08c-32f4-ea11-b882-24ee9a37d45c",-73728412,40756481,"P.S. 811 (OLD 187) - QUEENS","61-25 MARATHON PARKWAY"
2,2,0,"48507380-31f4-ea11-b882-24ee9a37d45c","Amistad Dual Language School - M311 - M176 - 06M311 - 4862 BROADWAY","46507380-31f4-ea11-b882-24ee9a37d45c",-73923818,40866381,"P.S./I.S. 176 - MANHATTAN","4862 BROADWAY"
1,1,0,"ab343d0d-85ef-eb11-b8b1-24ee9a37d45c","P.S. Q811 - Q811 - Q140 - 75Q811 - 166-01 116 AVENUE","c7883319-32f4-ea11-b882-24ee9a37d45c",-73781255,40687486,"P.S. 140 - QUEENS","166-01 116 AVENUE"
2,1,1,"725bc58c-30f4-ea11-b882-24ee9a37d45c","Urban Assembly School for Leadership and Empowerment - K609 - K223 - 20K609 - 4200 16 AVENUE","735bc58c-30f4-ea11-b882-24ee9a37d45c",-73982424,40635100,"I.S. 223 - BROOKLYN","4200 16 AVENUE"
1,0,1,"dfe13320-ebf6-ea11-b883-24ee9a37d459","P.S. K077 - K077 - K178 - 75K077 - 2163 DEAN STREET","0cd1de79-30f4-ea11-b882-24ee9a37d45c",-73915337,40675380,"P.S. 178 - BROOKLYN","2163 DEAN STREET"
2,0,2,"55fdc1bd-32f4-ea11-b882-24ee9a37d45c","P.S. 016 John J. Driscoll - R016 - R016 - 31R016 - 195 DANIEL LOW TERRACE","56fdc1bd-32f4-ea11-b882-24ee9a37d45c",-74079594,40639638,"P.S. 16 - STATEN ISLAND","195 DANIEL LOW TERRACE"
1,0,1,"397eed06-32f4-ea11-b882-24ee9a37d45c","P.S. 100 Glen Morris - Q100 - Q100 - 27Q100 - 111-11 118 Street","267eed06-32f4-ea11-b882-24ee9a37d45c",-73821545,40679694,"P.S. 100 - QUEENS","111-11 118 Street"
1,0,1,"a472c880-32f4-ea11-b882-24ee9a37d45c","Metropolitan Expeditionary Learning School - Q167 - Q686 - 28Q167 - 91-30 METROPOLITAN AVENUE","a372c880-32f4-ea11-b882-24ee9a37d45c",-73855543,40708431,"METROPOLITAN AVENUE CAMPUS - QUEENS","91-30 METROPOLITAN AVENUE"
2,2,0,"6c34aa92-31f4-ea11-b882-24ee9a37d45c","Success Academy Charter School - Harlem 6 - M357 - M389 - 84M357 - 461 West 131 Street","6d34aa92-31f4-ea11-b882-24ee9a37d45c",-73953570,40816158,"Success Academy - Harlem Central","461 West 131 Street"
1,1,0,"fbce496e-31f4-ea11-b882-24ee9a37d45c","P.S. 128 Audubon - M128 - M128 - 06M128 - 560 WEST 169 STREET","f9ce496e-31f4-ea11-b882-24ee9a37d45c",-73938701,40841032,"P.S. 128 - MANHATTAN","560 WEST 169 STREET"
1,0,1,"3cde5eb7-30f4-ea11-b882-24ee9a37d45c","Brownsville Collaborative Middle School - K363 - K298 - 23K363 - 85 WATKINS STREET","3dde5eb7-30f4-ea11-b882-24ee9a37d45c",-73907718,40671015,"P.S. 298 - BROOKLYN","85 WATKINS STREET"
1,0,1,"4c953aac-ebf6-ea11-b883-24ee9a37d459","P.S. Q255 - Q255 - Q397 - 75Q255 - 32-52 37th Street","a4eb6056-32f4-ea11-b882-24ee9a37d45c",-73920948,40759308,"PRE-K CENTER @37TH STREET - QUEENS","32-52 37th Street"
1,0,1,"fbfa079f-32f4-ea11-b882-24ee9a37d45c","Academy of the City Charter School - Q359 - QABE - 84Q359 - 31-29 60 STREET","fcfa079f-32f4-ea11-b882-24ee9a37d45c",-73902197,40756181,"CORPUS CHRISTI SCHOOL","31-29 60 STREET"
1,1,0,"cd315367-30f4-ea11-b882-24ee9a37d45c","P.S. 127 Mckinley Park - K127 - K127 - 20K127 - 7805 7 Avenue","ce315367-30f4-ea11-b882-24ee9a37d45c",-74018429,40623687,"P.S. 127 - BROOKLYN","7805 7 Avenue"
1,1,0,"df11f898-32f4-ea11-b882-24ee9a37d45c","P.S. 360 - Q360 - Q892 - 29Q360 - 199-10 112 AVENUE","e011f898-32f4-ea11-b882-24ee9a37d45c",-73756259,40702329,"P.S. 892 - QUEENS","199-10 112 AVENUE"
2,1,1,"0bc73b4a-32f4-ea11-b882-24ee9a37d45c","The Gordon Parks School - Q270 - Q270 - 29Q270 - 233-15 MERRICK BOULEVARD","52a10a44-32f4-ea11-b882-24ee9a37d45c",-73736232,40675070,"P.S. 270 - QUEENS","233-15 MERRICK BOULEVARD"
2,1,1,"efce496e-31f4-ea11-b882-24ee9a37d45c","P.S. 125 Ralph Bunche - M125 - M125 - 05M125 - 425 WEST 123 STREET","edce496e-31f4-ea11-b882-24ee9a37d45c",-73955722,40810793,"P.S. 125 - MANHATTAN","425 WEST 123 STREET"
1,1,0,"369f4974-31f4-ea11-b882-24ee9a37d45c","Manhattan Charter School - M320 - M142 - 84M320 - 100 ATTORNEY STREET","379f4974-31f4-ea11-b882-24ee9a37d45c",-73984116,40718121,"P.S. 142 - MANHATTAN","100 ATTORNEY STREET"
1,1,0,"82be7adc-32f4-ea11-b882-24ee9a37d45c","P.S. 65 The Academy of Innovative Learning - R065 - R829 - 31R065 - 98 GRANT STREET","83be7adc-32f4-ea11-b882-24ee9a37d45c",-74078337,40633666,"ARTHUR D. PHILLIPS SCHOOL - S.I.","98 GRANT STREET"
2,2,0,"8a41e65b-31f4-ea11-b882-24ee9a37d45c","P.S. 084 Lillian Weber - M084 - M084 - 03M084 - 32 West 92 Street","8b41e65b-31f4-ea11-b882-24ee9a37d45c",-73968419,40789479,"P.S. 84 - MANHATTAN","32 West 92 Street"
1,0,1,"e8c1392a-30f4-ea11-b882-24ee9a37d45c","Explore Charter School - K704 - K002 - 84K704 - 655 Parkside Avenue","dfc1392a-30f4-ea11-b882-24ee9a37d45c",-73951575,40656423,"I.S. 2 - BROOKLYN","655 Parkside Avenue"
1,0,1,"f602cefa-32f4-ea11-b882-24ee9a37d45c","P.S. 033 Timothy Dwight - X033 - X033 - 10X033 - 2424 JEROME AVENUE","f702cefa-32f4-ea11-b882-24ee9a37d45c",-73901268,40861698,"P.S. 33 - BRONX","2424 JEROME AVENUE"
1,0,1,"a3778cb8-ebf6-ea11-b883-24ee9a37d459","John F. Kennedy Jr. School - Q721 - Q585 - 75Q721 - 54-40 74TH STREET","34b4977a-32f4-ea11-b882-24ee9a37d45c",-73887909,40729104,"MASPETH HIGH SCHOOL - QUEENS","54-40 74TH STREET"
1,1,0,"e8b98b86-30f4-ea11-b882-24ee9a37d45c","M.S. 582 - K582 - K196 - 14K582 - 207 BUSHWICK AVENUE","e9b98b86-30f4-ea11-b882-24ee9a37d45c",-73939385,40708804,"P.S. 196 - BROOKLYN","207 BUSHWICK AVENUE"
3,1,2,"8c0e6e25-32f4-ea11-b882-24ee9a37d45c","Irwin Altman Middle School 172 - Q172 - Q172 - 26Q172 - 81-14 257 Street","8d0e6e25-32f4-ea11-b882-24ee9a37d45c",-73713245,40741409,"J.H.S. 172 - QUEENS","81-14 257 Street"
3,0,3,"d7b66262-32f4-ea11-b882-24ee9a37d45c","William Cullen Bryant High School - Q445 - Q445 - 30Q445 - 48-10 31 AVENUE","d8b66262-32f4-ea11-b882-24ee9a37d45c",-73911165,40757072,"WILLIAM C. BRYANT HS - Q","48-10 31 AVENUE"
2,2,0,"ed17b7f4-32f4-ea11-b882-24ee9a37d45c","P.S. 024 Spuyten Duyvil - X024 - X024 - 10X024 - 660 WEST 236 STREET","ee17b7f4-32f4-ea11-b882-24ee9a37d45c",-73915114,40886922,"P.S. 24 - BRONX","660 WEST 236 STREET"
2,2,0,"13ba8b86-30f4-ea11-b882-24ee9a37d45c","P.S. 206 Joseph F Lamb - K206 - K206 - 22K206 - 2200 GRAVESEND NECK ROAD","14ba8b86-30f4-ea11-b882-24ee9a37d45c",-73948453,40596876,"P.S. 206 - BROOKLYN","2200 GRAVESEND NECK ROAD"
1,1,0,"ffe1abc9-30f4-ea11-b882-24ee9a37d45c","I.S. 392 - K392 - K356 - 23K392 - 104 SUTTER AVENUE","35a198c3-30f4-ea11-b882-24ee9a37d45c",-73917880,40665553,"P.S. 156 - BROOKLYN","104 SUTTER AVENUE"
1,1,0,"479f4974-31f4-ea11-b882-24ee9a37d45c","P.S. 242 - The Young Diplomats Magnet Academy - M242 - M144 - 03M242 - 134 WEST 122 STREET","459f4974-31f4-ea11-b882-24ee9a37d45c",-73948385,40806055,"P.S. 242 (OLD P144) - MANHATTAN","134 WEST 122 STREET"
2,1,1,"920e6e25-32f4-ea11-b882-24ee9a37d45c","P.S. 174 William Sidney Mount - Q174 - Q174 - 28Q174 - 65-10 DIETERLE CRESCENT","930e6e25-32f4-ea11-b882-24ee9a37d45c",-73861462,40720583,"P.S. 174 - QUEENS","65-10 DIETERLE CRESCENT"
1,0,1,"a5dab801-ecf6-ea11-b883-24ee9a37d459","Rose Hill Pre-K Center - X535 - X432 - 10X535 - 2490-2500 WEBSTER AVENUE","ae3aa668-33f4-ea11-b882-24ee9a37d45c",-73891838,40860601,"PRE-K CENTER @WEBSTER AVENUE - BRONX","2490-2500 WEBSTER AVENUE"
6,0,6,"be2ff20c-32f4-ea11-b882-24ee9a37d45c","P.S. 111 Jacob Blackwell - Q111 - Q111 - 30Q111 - 37-15 13 STREET","ad2ff20c-32f4-ea11-b882-24ee9a37d45c",-73939181,40758342,"P.S. 111 - QUEENS","37-15 13 STREET"
3,2,1,"4c9d7c62-33f4-ea11-b882-24ee9a37d45c","High School of Language and Innovation - X509 - X415 - 11X509 - 925 ASTOR AVENUE","439d7c62-33f4-ea11-b882-24ee9a37d45c",-73860729,40860443,"CHRISTOPHER COLUMBUS HS - X","925 ASTOR AVENUE"
2,1,1,"68e03d56-33f4-ea11-b882-24ee9a37d45c","P.S. 360 - X360 - X360 - 10X360 - 2880 KINGSBRIDGE TERRACE","69e03d56-33f4-ea11-b882-24ee9a37d45c",-73902214,40874717,"P.S. 360 - BRONX","2880 KINGSBRIDGE TERRACE"
2,2,0,"100410ca-32f4-ea11-b882-24ee9a37d45c","P.S. 042 Eltingville - R042 - R042 - 31R042 - 380 GENESEE AVENUE","110410ca-32f4-ea11-b882-24ee9a37d45c",-74169038,40552213,"P.S. 42 - STATEN ISLAND","380 GENESEE AVENUE"
1,1,0,"3e2f7d06-31f4-ea11-b882-24ee9a37d45c","P.S. 207 Elizabeth G. Leary - K207 - K729 - 22K207 - 3874 Flatlands Avenue","3f2f7d06-31f4-ea11-b882-24ee9a37d45c",-73935842,40619891,"P.S. 207 ANNEX - BROOKLYN","3874 Flatlands Avenue"
1,0,1,"2fa198c3-30f4-ea11-b882-24ee9a37d45c","Frederick Douglass Academy VIII Middle School - K452 - K346 - 19K452 - 1400 PENNSYLVANIA AVENUE","30a198c3-30f4-ea11-b882-24ee9a37d45c",-73881997,40646640,"P.S. 346 - BROOKLYN","1400 PENNSYLVANIA AVENUE"
3,3,0,"8036d900-33f4-ea11-b882-24ee9a37d45c","P.S. 061 Francisco Oller - X061 - X061 - 12X061 - 1550 CROTONA PARK EAST","7e36d900-33f4-ea11-b882-24ee9a37d45c",-73892784,40836156,"P.S. 61 - BRONX","1550 CROTONA PARK EAST"
2,0,2,"d917b7f4-32f4-ea11-b882-24ee9a37d45c","PS/MS 20 P.O.George J. Werdann, III - X020 - X020 - 10X020 - 3050 WEBSTER AVENUE","d817b7f4-32f4-ea11-b882-24ee9a37d45c",-73878731,40869482,"P.S. 20 - BRONX","3050 WEBSTER AVENUE"
1,0,1,"dd968d36-30f4-ea11-b882-24ee9a37d45c","P.S. 021 Crispus Attucks - K021 - K021 - 16K021 - 180 CHAUNCEY STREET","dc968d36-30f4-ea11-b882-24ee9a37d45c",-73926673,40680350,"P.S. 21 - BROOKLYN","180 CHAUNCEY STREET"
4,4,0,"27005d7a-31f4-ea11-b882-24ee9a37d45c","P.S. 163 Alfred E. Smith - M163 - M163 - 03M163 - 163 West 97 Street","26005d7a-31f4-ea11-b882-24ee9a37d45c",-73968470,40795163,"P.S. 163 - MANHATTAN","163 West 97 Street"
1,0,1,"9b476368-32f4-ea11-b882-24ee9a37d45c","Veritas Academy - Q240 - Q460 - 25Q240 - 35-01 UNION STREET","97476368-32f4-ea11-b882-24ee9a37d45c",-73826811,40764892,"FLUSHING HS - Q","35-01 UNION STREET"
2,2,0,"062ed53d-33f4-ea11-b882-24ee9a37d45c","Hostos-Lincoln Academy of Science - X500 - X162 - 07X500 - 600 SAINT ANN'S AVENUE","032ed53d-33f4-ea11-b882-24ee9a37d45c",-73912038,40814857,"I.S. 162 - BRONX","600 SAINT ANN'S AVENUE"
