"TotalCases","StudentCases","EmployeeCases","nycsr_locationsiteid","nycsr_sitename","nycsr_building.nycsr_buildingid","nycsr_building.nycsr_longitude","nycsr_building.nycsr_latitude","nycsr_building.nycsr_buildingname","nycsr_building.nycsr_address"
3,0,3,"8f53dd74-33f4-ea11-b882-24ee9a37d45c","Eagle Academy for Young Men - X231 - X465 - 09X231 - 4143 Third Avenue","8b53dd74-33f4-ea11-b882-24ee9a37d45c",-73897479,40845366,"Eagle Academy For Young Men - Bronx","4143 Third Avenue"
2,0,2,"0ee2abc9-30f4-ea11-b882-24ee9a37d45c","P.S. 371 - Lillian L. Rashkis - K371 - K371 - 75K371 - 355 37 STREET","0de2abc9-30f4-ea11-b882-24ee9a37d45c",-74005168,40654306,"P.S. 371 (OLD 615) - BROOKLYN","355 37 STREET"
23,7,16,"692b3eee-30f4-ea11-b882-24ee9a37d45c","Franklin Delano Roosevelt High School - K505 - K505 - 20K505 - 5800 20 AVENUE","682b3eee-30f4-ea11-b882-24ee9a37d45c",-73982583,40621299,"FRANKLIN D. ROOSEVELT HS - K","5800 20 AVENUE"
2,0,2,"55953aac-ebf6-ea11-b883-24ee9a37d459","Mosaic Pre-K Center - Q331 - Q412 - 24Q331 - 107-17 NORTHERN BOULEVARD","82e2635c-32f4-ea11-b882-24ee9a37d45c",-73861666,0,"PRE-K CENTER @NORTHERN BOULEVARD - QUEENS","107-17 NORTHERN BOULEVARD"
19,9,10,"89977d2b-32f4-ea11-b882-24ee9a37d45c","J.H.S. 194 William Carr - Q194 - Q194 - 25Q194 - 154-60 17 AVENUE","8a977d2b-32f4-ea11-b882-24ee9a37d45c",-73806990,40783231,"J.H.S. 194 - QUEENS","154-60 17 AVENUE"
3,2,1,"9948b1f5-eaf6-ea11-b883-24ee9a37d459","P.S. K134 - K134 - K849 - 22K134 - 4001 18 AVENUE","12d8cf12-31f4-ea11-b882-24ee9a37d45c",-73973180,40632145,"P.S. 134 - BROOKLYN","4001 18 AVENUE"
7,3,4,"d9fab455-31f4-ea11-b882-24ee9a37d45c","Earth School - M364 - M064 - 01M364 - 600 EAST 6 STREET","d3fab455-31f4-ea11-b882-24ee9a37d45c",-73981597,40723130,"P.S. 64 (OLD 71) - MANHATTAN","600 EAST 6 STREET"
2,2,0,"d99319d7-ebf6-ea11-b883-24ee9a37d459","The Richmond Pre-K Center - R066 - R068 - 31R066 - 1 TELEPORT DRIVE","d98521d0-32f4-ea11-b882-24ee9a37d45c",-74178183,0,"PRE-K CENTER @ 1 TELEPORT DRIVE - STATEN ISLAND","1 TELEPORT DRIVE"
2,0,2,"ab0e6e25-32f4-ea11-b882-24ee9a37d45c","P.S. 183 Dr. Richard R. Green - Q183 - Q183 - 27Q183 - 2-45 BEACH 79 STREET","a30e6e25-32f4-ea11-b882-24ee9a37d45c",-73805866,40589220,"P.S. 183 - QUEENS","2-45 BEACH 79 STREET"
2,2,0,"cdfab455-31f4-ea11-b882-24ee9a37d45c","Neighborhood School - M363 - M063 - 01M363 - 121 EAST 3 STREET","cefab455-31f4-ea11-b882-24ee9a37d45c",-73986214,40724440,"P.S. 63 - MANHATTAN","121 EAST 3 STREET"
3,0,3,"a732c3fb-eaf6-ea11-b883-24ee9a37d459","P.S. Q177 - Q177 - Q177 - 75Q177 - 56-37 188 STREET","8b0e6e25-32f4-ea11-b882-24ee9a37d45c",-73787419,40743400,"P.S. 177 - QUEENS","56-37 188 STREET"
4,0,4,"68f4a0ef-eaf6-ea11-b883-24ee9a37d459","P.S. K811 Connie Lekas School - K811 - K286 - 75K811 - 2525 HARING STREET","6e283fb1-30f4-ea11-b882-24ee9a37d45c",-73938610,40591132,"P.S. 811 (OLD P286) - BROOKLYN","2525 HARING STREET"
1,0,1,"0fcf496e-31f4-ea11-b882-24ee9a37d45c","P.S. 132 Juan Pablo Duarte - M132 - M132 - 06M132 - 185 WADSWORTH AVENUE","10cf496e-31f4-ea11-b882-24ee9a37d45c",-73933964,40850561,"P.S. 132 - MANHATTAN","185 WADSWORTH AVENUE"
3,0,3,"57953aac-ebf6-ea11-b883-24ee9a37d459","P.S. Q993 - Q993 - Q415 - 75Q993 - 57-00 223RD STREET","86e2635c-32f4-ea11-b882-24ee9a37d45c",-73757271,0,"BENJAMIN N. CARDOZO HS - Q","57-00 223RD STREET"
4,3,1,"d9cecd95-f07b-ed11-b0c6-088e901ef405","Essex Street Academy - M294 - M447 - 02M294 - 350 Grand Street","dacecd95-f07b-ed11-b0c6-088e901ef405",-73989329,0,"SEWARD PARK AF - MANHATTAN","350 Grand Street"
2,0,2,"07f32ce2-31f4-ea11-b882-24ee9a37d45c","P.S. 014 Fairview - Q014 - Q014 - 24Q014 - 107-01 OTIS AVENUE","faf22ce2-31f4-ea11-b882-24ee9a37d45c",-73854570,40741020,"P.S. 14 - QUEENS","107-01 OTIS AVENUE"
2,2,0,"8a34aa92-31f4-ea11-b882-24ee9a37d45c","Essex Street Academy - M294 - M445 - 02M294 - 350 GRAND STREET","8834aa92-31f4-ea11-b882-24ee9a37d45c",-73989329,0,"SEWARD PARK HS - MANHATTAN","350 GRAND STREET"
4,0,4,"22e2abc9-30f4-ea11-b882-24ee9a37d45c","P.S. /I.S. 384 Frances E. Carter - K384 - K384 - 32K384 - 242 COOPER STREET","21e2abc9-30f4-ea11-b882-24ee9a37d45c",-73904695,40689883,"P.S. 384 - BROOKLYN","242 COOPER STREET"
1,1,0,"989c11e8-30f4-ea11-b882-24ee9a37d45c","Millennium Brooklyn HS - K684 - K460 - 15K684 - 237 7 AVENUE","929c11e8-30f4-ea11-b882-24ee9a37d45c",-73978580,40669255,"John Jay Educational Campus","237 7 AVENUE"
5,3,2,"c2fc24e8-31f4-ea11-b882-24ee9a37d45c","World Journalism Preparatory: A College Board School - Q285 - Q025 - 25Q285 - 34-65 192 STREET","befc24e8-31f4-ea11-b882-24ee9a37d45c",-73789365,0,"J.H.S. 25 - QUEENS","34-65 192 STREET"
2,2,0,"cc0d3c5b-30f4-ea11-b882-24ee9a37d45c","P.S. 97 The Highlawn - K097 - K097 - 21K097 - 1846 West 13 Street","cd0d3c5b-30f4-ea11-b882-24ee9a37d45c",-73985570,40601191,"P.S. 97 - BROOKLYN","1846 West 13 Street"
1,0,1,"f58a0044-33f4-ea11-b882-24ee9a37d45c","The Urban Assembly Bronx Academy of Letters - X551 - X183 - 07X551 - 339 MORRIS AVENUE","ef8a0044-33f4-ea11-b882-24ee9a37d45c",-73925995,0,"J.H.S. 203 - BRONX","339 MORRIS AVENUE"
11,8,3,"fcae0313-32f4-ea11-b882-24ee9a37d45c","I.S. 125 Thom J. McCann Woodside - Q125 - Q125 - 24Q125 - 46-02 47 AVENUE","fdae0313-32f4-ea11-b882-24ee9a37d45c",-73918762,40740452,"I.S. 125 - QUEENS","46-02 47 AVENUE"
4,1,3,"4c88e6db-30f4-ea11-b882-24ee9a37d45c","International High School at Prospect Heights - K524 - K440 - 17K524 - 883 CLASSON AVENUE","4a88e6db-30f4-ea11-b882-24ee9a37d45c",-73960689,40669805,"PROSPECT HEIGHTS HS - K","883 CLASSON AVENUE"
1,0,1,"1f70f999-ebf6-ea11-b883-24ee9a37d459","P.S. Q255 - Q255 - Q154 - 75Q255 - 75-02 162 Street","d69b4c1f-32f4-ea11-b882-24ee9a37d45c",-73807750,40726473,"P.S. 154 - QUEENS","75-02 162 Street"
2,1,1,"8f977d2b-32f4-ea11-b882-24ee9a37d45c","P.S. 196 Grand Central Parkway - Q196 - Q196 - 28Q196 - 71-25 113 STREET","90977d2b-32f4-ea11-b882-24ee9a37d45c",-73837379,40722792,"P.S. 196 - QUEENS","71-25 113 STREET"
1,1,0,"58767649-31f4-ea11-b882-24ee9a37d45c","Urban Assembly School for the Performing Arts - M369 - M043 - 05M369 - 509 WEST 129 STREET","59767649-31f4-ea11-b882-24ee9a37d45c",-73955520,40815747,"I.S. 172 (OLD 43) - MANHATTAN","509 WEST 129 STREET"
2,0,2,"46b4977a-32f4-ea11-b882-24ee9a37d45c","Aviation Career & Technical Education High School - Q610 - Q610 - 24Q610 - 45-30 36 STREET","44b4977a-32f4-ea11-b882-24ee9a37d45c",-73929577,40743309,"AVIATION HS - Q","45-30 36 STREET"
4,2,2,"d1d27c6d-30f4-ea11-b882-24ee9a37d45c","The Brooklyn New School, P.S. 146 - K146 - K142 - 15K146 - 610 HENRY STREET","cfd27c6d-30f4-ea11-b882-24ee9a37d45c",-74002022,40679462,"J.H.S. 142 - BROOKLYN","610 HENRY STREET"
1,0,1,"4c5bc58c-30f4-ea11-b882-24ee9a37d45c","P.S. 214 Michael Friedsam - K214 - K214 - 19K214 - 2944 PITKIN AVENUE","4b5bc58c-30f4-ea11-b882-24ee9a37d45c",-73862961,40675881,"P.S. 214 - BROOKLYN","2944 PITKIN AVENUE"
3,0,3,"1a9ebaee-32f4-ea11-b882-24ee9a37d45c","P.S. 008 Isaac Varian - X008 - X008 - 10X008 - 3010 BRIGGS AVENUE","1b9ebaee-32f4-ea11-b882-24ee9a37d45c",-73883339,40872259,"P.S. 8 - BRONX","3010 BRIGGS AVENUE"
4,2,2,"515bc58c-30f4-ea11-b882-24ee9a37d45c","P.S. 215 Morris H. Weiss - K215 - K215 - 21K215 - 415 AVENUE S","505bc58c-30f4-ea11-b882-24ee9a37d45c",-73970171,40602722,"P.S. 215 - BROOKLYN","415 AVENUE S"
2,1,1,"9d32c3fb-eaf6-ea11-b883-24ee9a37d459","P.S. 009 - Q009 - Q009 - 75Q009 - 58-74 57 STREET","f8f22ce2-31f4-ea11-b882-24ee9a37d45c",-73912458,0,"P.S. 9 (W REED SCHOOL) - QUEENS","58-74 57 STREET"
1,0,1,"cb85f462-ebf6-ea11-b883-24ee9a37d459","P.S. M811 - Mickey Mantle School - M811 - M155 - 75M811 - 319 EAST 117 STREET","15005d7a-31f4-ea11-b882-24ee9a37d45c",-73935895,40797507,"P.S. 155 - MANHATTAN","319 EAST 117 STREET"
2,0,2,"340410ca-32f4-ea11-b882-24ee9a37d45c","The Barbara Esselborn School - R053 - R053 - 31R053 - 330 DURANT AVENUE","350410ca-32f4-ea11-b882-24ee9a37d45c",-74136640,0,"P.S. 53 - STATEN ISLAND","330 DURANT AVENUE"
10,4,6,"4c8dbfcf-30f4-ea11-b882-24ee9a37d45c","Midwood High School - K405 - K405 - 22K405 - 2839 BEDFORD AVENUE","4d8dbfcf-30f4-ea11-b882-24ee9a37d45c",-73952356,40632829,"MIDWOOD HS - K","2839 BEDFORD AVENUE"
3,0,3,"16a31781-33f4-ea11-b882-24ee9a37d45c","Bronx Leadership Academy II High School - X527 - X790 - 07X527 - 730 CONCOURSE VILLAGE WEST","0ea31781-33f4-ea11-b882-24ee9a37d45c",-73922366,40821828,"MOTT HAVEN EDUCATIONAL CAMPUS - BRONX","730 CONCOURSE VILLAGE WEST"
3,1,2,"ec968d36-30f4-ea11-b882-24ee9a37d45c","P.S. 024 - K024 - K024 - 15K024 - 427 38 STREET","ed968d36-30f4-ea11-b882-24ee9a37d45c",-74004533,40652832,"P.S. 24 - BROOKLYN","427 38 STREET"
3,0,3,"31c73b4a-32f4-ea11-b882-24ee9a37d45c","Elm Tree Elementary School - Q211 - Q298 - 24Q211 - 50-51 98th Street","30c73b4a-32f4-ea11-b882-24ee9a37d45c",-73863408,40741139,"Marie M. Daly Educational Building","50-51 98th Street"
2,1,1,"f4201dab-30f4-ea11-b882-24ee9a37d45c","I.S. 281 Joseph B Cavallaro - K281 - K281 - 21K281 - 8787 24 AVENUE","f2201dab-30f4-ea11-b882-24ee9a37d45c",-73993565,40594648,"I.S. 281 - BROOKLYN","8787 24 AVENUE"
5,3,2,"347c21b7-32f4-ea11-b882-24ee9a37d45c","P.S. 003 The Margaret Gioiosa School - R003 - R003 - 31R003 - 80 SOUTH GOFF AVENUE","357c21b7-32f4-ea11-b882-24ee9a37d45c",-74211850,40520812,"P.S. 3 - STATEN ISLAND","80 SOUTH GOFF AVENUE"
3,2,1,"429f4974-31f4-ea11-b882-24ee9a37d45c","Washington Heights Expeditionary Learning School - M348 - M143 - 06M348 - 511 WEST 182ND STREET","3f9f4974-31f4-ea11-b882-24ee9a37d45c",-73930991,40849311,"I.S. 143 - MANHATTAN","511 WEST 182ND STREET"
3,0,3,"77a9d9c3-32f4-ea11-b882-24ee9a37d45c","I.S. 027 Anning S. Prall - R027 - R027 - 31R027 - 11 CLOVE LAKE PLACE","78a9d9c3-32f4-ea11-b882-24ee9a37d45c",-74117818,40628291,"I.S. 27 - STATEN ISLAND","11 CLOVE LAKE PLACE"
17,11,6,"e292e6d5-30f4-ea11-b882-24ee9a37d45c","James Madison High School - K425 - K425 - 22K425 - 3787 BEDFORD AVENUE","e092e6d5-30f4-ea11-b882-24ee9a37d45c",-73947661,40610499,"JAMES MADISON HS - K","3787 BEDFORD AVENUE"
1,0,1,"397eed06-32f4-ea11-b882-24ee9a37d45c","P.S. 100 Glen Morris - Q100 - Q100 - 27Q100 - 111-11 118 Street","267eed06-32f4-ea11-b882-24ee9a37d45c",-73821545,40679694,"P.S. 100 - QUEENS","111-11 118 Street"
1,1,0,"a0dab801-ecf6-ea11-b883-24ee9a37d459","P.S. X721 - Stephen McSweeney School - X721 - X423 - 75X721 - 1551 EAST 172ND STREET","639d7c62-33f4-ea11-b882-24ee9a37d45c",-73878191,40832508,"JAMES MONROE HS CAMPUS ANNEX - BRONX","1551 EAST 172ND STREET"
2,1,1,"31e61462-31f4-ea11-b882-24ee9a37d45c","M.S. 319 - Maria Teresa - M319 - M090 - 06M319 - 21 JUMEL PLACE","2ce61462-31f4-ea11-b882-24ee9a37d45c",-73935815,40839139,"I.S. 90 - MANHATTAN","21 JUMEL PLACE"
1,0,1,"874270a5-ab33-ed11-b0a6-088e901ef405","P186X Walter J. Damrosch School - X186 - X088 - 75X186 - 1340 SHERIDAN AVENUE","1f474313-33f4-ea11-b882-24ee9a37d45c",-73913523,40837019,"P.S. 88 - BRONX","1340 SHERIDAN AVENUE"
4,1,3,"7ef4a0ef-eaf6-ea11-b883-24ee9a37d459","P.S. K721 - Brooklyn Occupational Training Center - K721 - K722 - 75K721 - 64 AVENUE X","392f7d06-31f4-ea11-b882-24ee9a37d45c",-73981925,40588070,"P.S. 721 OTC - BROOKLYN","64 AVENUE X"
3,2,1,"3b0d6d19-33f4-ea11-b882-24ee9a37d45c","P.S. 106 Parkchester - X106 - X106 - 11X106 - 1514 OLMSTEAD AVENUE","3c0d6d19-33f4-ea11-b882-24ee9a37d45c",-73854823,40836974,"P.S. 106 - BRONX","1514 OLMSTEAD AVENUE"
1,0,1,"e9e0a4fb-ebf6-ea11-b883-24ee9a37d459","P.S. X721 - Stephen McSweeney School - X721 - X368 - 75X721 - 2975 TIBBETT AVENUE","74e03d56-33f4-ea11-b882-24ee9a37d45c",-73913694,40877935,"M.S./H.S. 368 - BRONX","2975 TIBBETT AVENUE"
1,0,1,"ebb98b86-30f4-ea11-b882-24ee9a37d45c","P.S. 194 Raoul Wallenberg - K194 - K194 - 22K194 - 3117 AVENUE W","ecb98b86-30f4-ea11-b882-24ee9a37d45c",-73934163,40598069,"P.S. 194 - BROOKLYN","3117 AVENUE W"
2,1,1,"a32ff20c-32f4-ea11-b882-24ee9a37d45c","P.S. 101 School in the Gardens - Q101 - Q101 - 28Q101 - 2 RUSSELL PLACE","a42ff20c-32f4-ea11-b882-24ee9a37d45c",-73843400,40715543,"P.S. 101 - QUEENS","2 RUSSELL PLACE"
2,1,1,"e4201dab-30f4-ea11-b882-24ee9a37d45c","P.S. 277 Gerritsen Beach - K277 - K277 - 22K277 - 2529 GERRITSEN AVENUE","e5201dab-30f4-ea11-b882-24ee9a37d45c",-73927850,40595798,"P.S. 277 - BROOKLYN","2529 GERRITSEN AVENUE"
1,0,1,"949c11e8-30f4-ea11-b882-24ee9a37d45c","John Jay School for Law - K462 - K460 - 15K462 - 237 7 AVENUE","929c11e8-30f4-ea11-b882-24ee9a37d45c",-73978580,40669255,"John Jay Educational Campus","237 7 AVENUE"
2,0,2,"1dc73b4a-32f4-ea11-b882-24ee9a37d45c","PS280Q: Home of the Lionhearts - Q280 - Q280 - 30Q280 - 34-20 94th Street","1cc73b4a-32f4-ea11-b882-24ee9a37d45c",-73874109,40753345,"P.S. 280 - QUEENS","34-20 94th Street"
3,0,3,"3902fdd0-ebf6-ea11-b883-24ee9a37d459","The David Marquis School of the Arts - R037 - R004 - 75R037 - 200 NEDRA LANE","337c21b7-32f4-ea11-b882-24ee9a37d45c",-74195281,0,"P.S. 4 - STATEN ISLAND","200 NEDRA LANE"
2,2,0,"d479df48-30f4-ea11-b882-24ee9a37d45c","Community Roots Charter School - K536 - K067 - 84K536 - 51 SAINT EDWARDS STREET","d179df48-30f4-ea11-b882-24ee9a37d45c",-73977674,40695339,"P.S. 67 - BROOKLYN","51 SAINT EDWARDS STREET"
3,0,3,"0d0410ca-32f4-ea11-b882-24ee9a37d45c","The Stephanie A. Vierno School - R041 - R041 - 31R041 - 216 CLAWSON STREET","0e0410ca-32f4-ea11-b882-24ee9a37d45c",-74108492,40573599,"P.S. 41 - STATEN ISLAND","216 CLAWSON STREET"
1,0,1,"039c4c1f-32f4-ea11-b882-24ee9a37d45c","P.S. 163 Flushing Heights - Q163 - Q163 - 25Q163 - 159-01 59 AVENUE","049c4c1f-32f4-ea11-b882-24ee9a37d45c",-73808765,40741107,"P.S. 163 - QUEENS","159-01 59 AVENUE"
6,6,0,"d7f57030-30f4-ea11-b882-24ee9a37d45c","Public School 9 The Sarah Smith Garnet School - K009 - K009 - 13K009 - 80 UNDERHILL AVENUE","d8f57030-30f4-ea11-b882-24ee9a37d45c",-73966333,40678554,"P.S. 9 - BROOKLYN","80 UNDERHILL AVENUE"
1,0,1,"4f29a44a-ebf6-ea11-b883-24ee9a37d459","Adult and Continuing Education - K755 - K814 - 79K755 - 265 WARWICK STREET","a928a20c-31f4-ea11-b882-24ee9a37d45c",-73886712,40677707,"CYPRESS HILLS COMMUNITY SCHOOL - BROOKLYN","265 WARWICK STREET"
8,6,2,"5d07e99e-31f4-ea11-b882-24ee9a37d45c","Stuyvesant High School - M475 - M477 - 02M475 - 345 CHAMBERS STREET","5c07e99e-31f4-ea11-b882-24ee9a37d45c",-74013921,0,"STUYVESANT HS (NEW) - MANHATTAN","345 CHAMBERS STREET"
2,2,0,"cbd27c6d-30f4-ea11-b882-24ee9a37d45c","P.S. 139 Alexine A. Fenty - K139 - K139 - 22K139 - 330 RUGBY ROAD","cad27c6d-30f4-ea11-b882-24ee9a37d45c",-73965862,40641340,"P.S. 139 - BROOKLYN","330 RUGBY ROAD"
1,0,1,"6c41e65b-31f4-ea11-b882-24ee9a37d45c","The Lexington Academy - M072 - M072 - 04M072 - 131 EAST 104 STREET","6d41e65b-31f4-ea11-b882-24ee9a37d45c",-73947450,40791444,"P.S. 72 - MANHATTAN","131 EAST 104 STREET"
1,0,1,"cee0838c-31f4-ea11-b882-24ee9a37d45c","The River School - M281 - M281 - 02M281 - 425 East 35 Street","cde0838c-31f4-ea11-b882-24ee9a37d45c",-73972592,40744288,"P.S. 281 - MANHATTAN","425 East 35 Street"
3,3,0,"dbfab455-31f4-ea11-b882-24ee9a37d45c","Tompkins Square Middle School - M839 - M064 - 01M839 - 600 EAST 6 STREET","d3fab455-31f4-ea11-b882-24ee9a37d45c",-73981597,40723130,"P.S. 64 (OLD 71) - MANHATTAN","600 EAST 6 STREET"
3,0,3,"fcb98b86-30f4-ea11-b882-24ee9a37d45c","P.S. 199 Frederick Wachtel - K199 - K199 - 21K199 - 1100 ELM AVENUE","fdb98b86-30f4-ea11-b882-24ee9a37d45c",-73963026,40616310,"P.S. 199 - BROOKLYN","1100 ELM AVENUE"
2,0,2,"7907e99e-31f4-ea11-b882-24ee9a37d45c","Art and Design High School - M630 - M488 - 02M630 - 231-249 EAST 56 STREET","6d07e99e-31f4-ea11-b882-24ee9a37d45c",-73967204,40759248,"MIDTOWN EAST CAMPUS - MANHATTAN","231-249 EAST 56 STREET"
6,3,3,"9069c231-32f4-ea11-b882-24ee9a37d45c","Robert H. Goddard High School of Communication Arts and Technology - Q308 - Q202 - 27Q308 - 138-30 LAFAYETTE STREET","9169c231-32f4-ea11-b882-24ee9a37d45c",-73845992,0,"I.S. 202 - QUEENS","138-30 LAFAYETTE STREET"
4,0,4,"480b210d-33f4-ea11-b882-24ee9a37d45c","P.S. X811 - X811 - X084 - 75X811 - 1434 Longfellow Avenue","490b210d-33f4-ea11-b882-24ee9a37d45c",-73886798,40830552,"P.S. 811 (OLD I84) - BRONX","1434 Longfellow Avenue"
12,9,3,"d2b66262-32f4-ea11-b882-24ee9a37d45c","Forest Hills High School - Q440 - Q440 - 28Q440 - 67-01 110 STREET","d3b66262-32f4-ea11-b882-24ee9a37d45c",-73843972,40730017,"FOREST HILLS HS - Q","67-01 110 STREET"
2,1,1,"dbe13320-ebf6-ea11-b883-24ee9a37d459","Sid Miller Academy - K396 - K167 - 75K396 - 1025 EASTERN PARKWAY","4cebaa73-30f4-ea11-b882-24ee9a37d45c",-73934316,40669557,"P.S. 167 - BROOKLYN","1025 EASTERN PARKWAY"
2,0,2,"270b210d-33f4-ea11-b882-24ee9a37d45c","P.S. 195 - X195 - X077 - 12X195 - 1250 WARD AVENUE","230b210d-33f4-ea11-b882-24ee9a37d45c",-73877305,40830811,"P.S. 195 - BRONX","1250 WARD AVENUE"
1,0,1,"ab343d0d-85ef-eb11-b8b1-24ee9a37d45c","P.S. Q811 - Q811 - Q140 - 75Q811 - 166-01 116 AVENUE","c7883319-32f4-ea11-b882-24ee9a37d45c",-73781255,0,"P.S. 140 - QUEENS","166-01 116 AVENUE"
5,0,5,"78f4a0ef-eaf6-ea11-b883-24ee9a37d459","Sid Miller Academy - K396 - K396 - 75K396 - 110 CHESTER STREET","2d8dbfcf-30f4-ea11-b882-24ee9a37d45c",-73911788,40668232,"P.S. 396 (TANDEM K327-D23)-K","110 CHESTER STREET"
2,0,2,"aa8fd48d-ebf6-ea11-b883-24ee9a37d459","P.S. Q811 - Q811 - Q037 - 75Q811 - 179-37 137 Avenue","d58442ee-31f4-ea11-b882-24ee9a37d45c",-73758778,40676201,"P.S. 37 - QUEENS","179-37 137 Avenue"
3,0,3,"fb8ac007-ebf6-ea11-b883-24ee9a37d459","P.S. X721 - Stephen McSweeney School - X721 - X722 - 75X721 - 2697 WESTCHESTER AVENUE","06a31781-33f4-ea11-b882-24ee9a37d45c",-73839114,40842725,"P.S. 721 (OTC) - BRONX","2697 WESTCHESTER AVENUE"
2,0,2,"433cbf01-ebf6-ea11-b883-24ee9a37d459","P.S. Q811 - Q811 - Q811 - 75Q811 - 61-25 MARATHON PARKWAY","08bef08c-32f4-ea11-b882-24ee9a37d45c",-73728412,40756481,"P.S. 811 (OLD 187) - QUEENS","61-25 MARATHON PARKWAY"
1,0,1,"d685f462-ebf6-ea11-b883-24ee9a37d459","P.S. M811 - Mickey Mantle School - M811 - M200 - 75M811 - 2589 7 AVENUE","848d8486-31f4-ea11-b882-24ee9a37d45c",-73935746,40823988,"P.S. 200 (TANDEM M010) - MANHATTAN","2589 7 AVENUE"
1,1,0,"6ebe7adc-32f4-ea11-b882-24ee9a37d45c","P.S. 001 Tottenville - R001 - R802 - 31R001 - 58 SUMMIT STREET","6fbe7adc-32f4-ea11-b882-24ee9a37d45c",-74243950,40508638,"P.S. 1 ANNEX - STATEN ISLAND","58 SUMMIT STREET"
2,0,2,"d28fd20d-ebf6-ea11-b883-24ee9a37d459","P.S. K140 - K140 - K005 - 75K140 - 820 HANCOCK STREET","edc1392a-30f4-ea11-b882-24ee9a37d45c",-73921970,40685241,"P.S. 5 - BROOKLYN","820 HANCOCK STREET"
4,3,1,"42e61462-31f4-ea11-b882-24ee9a37d45c","P.S. 096 Joseph Lanzetta - M096 - M096 - 04M096 - 216 EAST 120 STREET","43e61462-31f4-ea11-b882-24ee9a37d45c",-73937179,40799690,"P.S. 96 - MANHATTAN","216 EAST 120 STREET"
5,3,2,"6a5bc58c-30f4-ea11-b882-24ee9a37d45c","J.H.S. 220 John J. Pershing - K220 - K220 - 20K220 - 4812 9TH AVENUE","695bc58c-30f4-ea11-b882-24ee9a37d45c",-74001250,40640997,"I.S. 220 - BROOKLYN","4812 9TH AVENUE"
1,0,1,"88abe919-ecf6-ea11-b883-24ee9a37d459","Adult and Continuing Education - K755 - XASQ - 79K755 - 1666 BATHGATE AVENUE","d90347b2-33f4-ea11-b882-24ee9a37d45c",-73900334,40840948,"Education Opportunity Center","1666 BATHGATE AVENUE"
4,0,4,"3a767649-31f4-ea11-b882-24ee9a37d45c","P.S. 028 Wright Brothers - M028 - M028 - 06M028 - 475 WEST 155 STREET","3b767649-31f4-ea11-b882-24ee9a37d45c",-73942023,40831630,"P.S. 28 - MANHATTAN","475 WEST 155 STREET"
4,0,4,"b7b36d80-30f4-ea11-b882-24ee9a37d45c","P.S. K231 - K231 - K180 - 75K231 - 5601 16 AVENUE","b8b36d80-30f4-ea11-b882-24ee9a37d45c",-73989250,40626454,"P.S. 180 - BROOKLYN","5601 16 AVENUE"
2,1,1,"e4b36d80-30f4-ea11-b882-24ee9a37d45c","P.S. 192 - The Magnet School for Math and Science Inquiry - K192 - K192 - 20K192 - 4715 18 AVENUE","e5b36d80-30f4-ea11-b882-24ee9a37d45c",-73979540,40628800,"P.S. 192 - BROOKLYN","4715 18 AVENUE"
2,0,2,"95778cb8-ebf6-ea11-b883-24ee9a37d459","The Riverview School - Q277 - Q485 - 75Q277 - 21-27 HIMROD STREET","74bc9674-32f4-ea11-b882-24ee9a37d45c",-73909202,40711881,"GROVER CLEVELAND HS - Q","21-27 HIMROD STREET"
4,0,4,"e62d6c32-ebf6-ea11-b883-24ee9a37d459","P.S. K771 - K771 - K329 - 75K771 - 2929 WEST 30 STREET","11a198c3-30f4-ea11-b882-24ee9a37d45c",-73995770,40574666,"P.S. 329 - BROOKLYN","2929 WEST 30 STREET"
3,2,1,"e68a0044-33f4-ea11-b882-24ee9a37d45c","I.S. 181 Pablo Casals - X181 - X181 - 11X181 - 800 BAYCHESTER AVENUE","e78a0044-33f4-ea11-b882-24ee9a37d45c",-73831669,40874035,"I.S. 181 - BRONX","800 BAYCHESTER AVENUE"
7,4,3,"d60d3c5b-30f4-ea11-b882-24ee9a37d45c","P.S. 101 The Verrazano - K101 - K101 - 21K101 - 8696 24 Avenue","d70d3c5b-30f4-ea11-b882-24ee9a37d45c",-73991962,40597379,"P.S. 101 - BROOKLYN","8696 24 Avenue"
8,6,2,"a672c880-32f4-ea11-b882-24ee9a37d45c","Queens Metropolitan High School - Q686 - Q686 - 28Q686 - 91-30 METROPOLITAN AVENUE","a372c880-32f4-ea11-b882-24ee9a37d45c",-73855543,0,"METROPOLITAN AVENUE CAMPUS - QUEENS","91-30 METROPOLITAN AVENUE"
2,0,2,"76e2635c-32f4-ea11-b882-24ee9a37d45c","P.S. Q256 - Q256 - Q410 - 75Q256 - 100-00 BEACH CHANNEL DRIVE","71e2635c-32f4-ea11-b882-24ee9a37d45c",-73825317,40586012,"Beach Channel Educational Campus","100-00 BEACH CHANNEL DRIVE"
4,0,4,"4fa10a44-32f4-ea11-b882-24ee9a37d45c","P.S./I.S. 268 - Q268 - Q268 - 29Q268 - 92-07 175 STREET","4ea10a44-32f4-ea11-b882-24ee9a37d45c",-73785210,40707648,"P.S. 268 - QUEENS","92-07 175 STREET"
1,1,0,"337eed06-32f4-ea11-b882-24ee9a37d45c","P.S. 098 The Douglaston School - Q098 - Q098 - 26Q098 - 40-20 235 STREET","347eed06-32f4-ea11-b882-24ee9a37d45c",-73749998,40768906,"P.S. 98 - QUEENS","40-20 235 STREET"
6,2,4,"9034aa92-31f4-ea11-b882-24ee9a37d45c","High School for Dual Language and Asian Studies - M545 - M445 - 02M545 - 350 GRAND STREET","8834aa92-31f4-ea11-b882-24ee9a37d45c",-73989329,0,"SEWARD PARK HS - MANHATTAN","350 GRAND STREET"
2,0,2,"aabf14dd-ebf6-ea11-b883-24ee9a37d459","Pathways to Graduation - Q950 - R801 - 79Q950 - 450 ST MARKS PLACE","69be7adc-32f4-ea11-b882-24ee9a37d45c",-74077564,40638388,"AUX. SERV - ST. GEORGE SCHOOL-S.I.","450 ST MARKS PLACE"
1,1,0,"6541e65b-31f4-ea11-b882-24ee9a37d45c","New York City Lab Middle School for Collaborative Studies - M312 - M070 - 02M312 - 333 WEST 17 STREET","defab455-31f4-ea11-b882-24ee9a37d45c",-74002222,40742512,"I.S. 70 - MANHATTAN","333 WEST 17 STREET"
1,0,1,"69fdc1bd-32f4-ea11-b882-24ee9a37d45c","P.S. 022 Graniteville - R022 - R022 - 31R022 - 1860 Forest Avenue","6afdc1bd-32f4-ea11-b882-24ee9a37d45c",-74150544,40624847,"P.S. 22 - STATEN ISLAND","1860 Forest Avenue"
1,0,1,"a5edf392-32f4-ea11-b882-24ee9a37d45c","Joseph F. Quinn Intermediate School 77 - Q077 - Q849 - 24Q077 - 976 Seneca Avenue","a4edf392-32f4-ea11-b882-24ee9a37d45c",-73902147,40699101,"I.S. 77 - QUEENS","976 Seneca Avenue"
8,8,0,"ecce496e-31f4-ea11-b882-24ee9a37d45c","Columbia Secondary School - M362 - M125 - 05M362 - 425 WEST 123 STREET","edce496e-31f4-ea11-b882-24ee9a37d45c",-73955722,40810793,"P.S. 125 - MANHATTAN","425 WEST 123 STREET"
4,2,2,"362f7d06-31f4-ea11-b882-24ee9a37d45c","Brooklyn Studio Secondary School - K690 - K721 - 21K690 - 8310 21ST AVENUE","56416e00-31f4-ea11-b882-24ee9a37d45c",-73995084,40604980,"BROOKLYN STUDIO (TANDEM K128) - K","8310 21ST AVENUE"
2,1,1,"5f9f4974-31f4-ea11-b882-24ee9a37d45c","P.S. 154 Harriet Tubman - M154 - M154 - 05M154 - 250 WEST 127 STREET","609f4974-31f4-ea11-b882-24ee9a37d45c",-73948902,40810499,"P.S. 154 - MANHATTAN","250 WEST 127 STREET"
1,0,1,"0906003e-32f4-ea11-b882-24ee9a37d45c","I.S. 230 - Q230 - Q230 - 30Q230 - 73-10 34 AVENUE","0806003e-32f4-ea11-b882-24ee9a37d45c",-73892883,40752618,"I.S. 230 - QUEENS","73-10 34 AVENUE"
6,2,4,"6ce2635c-32f4-ea11-b882-24ee9a37d45c","Bayside High School - Q495 - Q405 - 26Q495 - 32-24 CORPORAL KENNEDY STREET","6be2635c-32f4-ea11-b882-24ee9a37d45c",-73781041,40771398,"BAYSIDE HS - Q","32-24 CORPORAL KENNEDY STREET"
1,0,1,"9f778cb8-ebf6-ea11-b883-24ee9a37d459","P.S. Q811 - Q811 - Q566 - 75Q811 - 74-20 COMMONWEALTH BLVD","27b4977a-32f4-ea11-b882-24ee9a37d45c",-73728834,0,"QNS HS OF TEACH., LIB. ARTS&SCI-Q","74-20 COMMONWEALTH BLVD"
5,2,3,"f917b7f4-32f4-ea11-b882-24ee9a37d45c","P.S. 396 - X396 - X026 - 10X396 - 1930 ANDREWS AVENUE","e917b7f4-32f4-ea11-b882-24ee9a37d45c",-73913016,40854335,"P.S. 396 - BRONX","1930 ANDREWS AVENUE"
3,2,1,"ef9b4c1f-32f4-ea11-b882-24ee9a37d45c","J.H.S. 157 Stephen A. Halsey - Q157 - Q157 - 28Q157 - 63-55 102ND STREET","f09b4c1f-32f4-ea11-b882-24ee9a37d45c",-73852879,40732348,"J.H.S. 157 - QUEENS","63-55 102ND STREET"
6,5,1,"dc0d3c5b-30f4-ea11-b882-24ee9a37d45c","P.S./I.S. 104 The Fort Hamilton School - K104 - K104 - 20K104 - 9115 5 AVENUE","dd0d3c5b-30f4-ea11-b882-24ee9a37d45c",-74028492,40618077,"P.S. 104 - BROOKLYN","9115 5 AVENUE"
9,7,2,"512b3eee-30f4-ea11-b882-24ee9a37d45c","Fort Hamilton High School - K490 - K490 - 20K490 - 8301 SHORE ROAD","522b3eee-30f4-ea11-b882-24ee9a37d45c",-74038103,40626827,"FORT HAMILTON HS - K","8301 SHORE ROAD"
3,1,2,"09a198c3-30f4-ea11-b882-24ee9a37d45c","P.S. 327 Dr. Rose B. English - K327 - K327 - 23K327 - 111 BRISTOL STREET","08a198c3-30f4-ea11-b882-24ee9a37d45c",-73911788,40668232,"P.S. 327 (TANDEM K396-D75)-K","111 BRISTOL STREET"
1,0,1,"1dbc749d-4afb-ea11-b883-24ee9a37d459","Tolentine Zeiser Community Life Center - XASH - XARI -  - 2340 Andrews Avenue","1ebc749d-4afb-ea11-b883-24ee9a37d459",-73906591,40862290,"Tolentine Zesier Community Life Center","2340 Andrews Avenue"
1,0,1,"116e3d68-31f4-ea11-b882-24ee9a37d45c","P.S. 138 - M138 - M114 - 75M138 - 331 EAST 91ST STREET","126e3d68-31f4-ea11-b882-24ee9a37d45c",-73947379,40780452,"EAST SIDE MIDDLE SCHOOL - MANHATTAN","331 EAST 91ST STREET"
2,1,1,"d39b4c1f-32f4-ea11-b882-24ee9a37d45c","P.S. 149 Christa McAuliffe - Q149 - Q149 - 30Q149 - 93-11 34 AVENUE","f3883319-32f4-ea11-b882-24ee9a37d45c",-73874505,40755759,"P.S. 149 - QUEENS","93-11 34 AVENUE"
1,0,1,"47a10a44-32f4-ea11-b882-24ee9a37d45c","P.S./I.S. 295 - Q295 - Q263 - 29Q295 - 222-14 JAMAICA AVENUE","41a10a44-32f4-ea11-b882-24ee9a37d45c",-73731398,40720617,"P.S. /I.S 295 - QUEENS","222-14 JAMAICA AVENUE"
2,0,2,"6ba5db98-30f4-ea11-b882-24ee9a37d45c","Mark Twain I.S. 239 for the Gifted & Talented - K239 - K239 - 21K239 - 2401 NEPTUNE AVENUE","6ca5db98-30f4-ea11-b882-24ee9a37d45c",-73992447,40578640,"I.S. 239 - BROOKLYN","2401 NEPTUNE AVENUE"
1,0,1,"8ba87f90-5a04-ec11-b8b4-24ee9a37d45c","Hunters Point Elementary School - Q384 - Q375 - 30Q384 - 1-35 57 Avenue","8ca87f90-5a04-ec11-b8b4-24ee9a37d45c",-73960836,0,"Hunters Point","1-35 57 Avenue"
1,0,1,"e2e13320-ebf6-ea11-b883-24ee9a37d459","Sid Miller Academy - K396 - K181 - 75K396 - 1023 NEW YORK AVENUE","bdb36d80-30f4-ea11-b882-24ee9a37d45c",-73945883,40648217,"P.S. 181 - BROOKLYN","1023 NEW YORK AVENUE"
1,1,0,"0fa6ba98-31f4-ea11-b882-24ee9a37d45c","University Neighborhood High School - M448 - M446 - 01M448 - 200 Monroe Street","10a6ba98-31f4-ea11-b882-24ee9a37d45c",-73984128,40712269,"UNIVERSITY NEIGHBORHOOD - M","200 Monroe Street"
1,0,1,"66e2635c-32f4-ea11-b882-24ee9a37d45c","Hunters Point Community Middle School - Q291 - Q404 - 30Q291 - 1-50 51ST AVENUE","65e2635c-32f4-ea11-b882-24ee9a37d45c",-73959183,0,"HUNTERS POINT CAMPUS - QUEENS","1-50 51ST AVENUE"
1,1,0,"1c005d7a-31f4-ea11-b882-24ee9a37d45c","Yorkville East Middle School - M177 - M158 - 02M177 - 1458 YORK AVENUE","1d005d7a-31f4-ea11-b882-24ee9a37d45c",-73950745,40770215,"P.S. 158 - MANHATTAN","1458 YORK AVENUE"
2,2,0,"d38521d0-32f4-ea11-b882-24ee9a37d45c","The Kathleen Grimm School for Leadership and Sustainability - R062 - R062 - 31R062 - 644 Bloomingdale Road","d48521d0-32f4-ea11-b882-24ee9a37d45c",-74217934,0,"K.GRIMM SCL FOR LDRSHP&SUSTAINABLTY@SANDY GR -S.I.","644 Bloomingdale Road"
2,0,2,"418dbfcf-30f4-ea11-b882-24ee9a37d45c","Kingsborough Early College School - K468 - K400 - 21K468 - 2630 BENSON AVENUE","3a8dbfcf-30f4-ea11-b882-24ee9a37d45c",-73986313,40593028,"Lafayette Educational Campus","2630 BENSON AVENUE"
1,0,1,"ec201dab-30f4-ea11-b882-24ee9a37d45c","Pre-K Center at Bishop Ford School Site - K863 - K280 - 15K863 - 500 19 STREET","ed201dab-30f4-ea11-b882-24ee9a37d45c",-73983116,40656952,"PRE-K CENTER @ 500 19TH STREET - BROOKLYN","500 19 STREET"
1,1,0,"f6bd0987-f27b-ed11-b0c6-088e901ef405","Marble Hill High School for International Studies - X477 - X476 - 10X477 - 99 Terrace View Avenue","88ef4741-f27b-ed11-b0c6-088e901ef405",-73912686,40877379,"KENNEDY AF - BRONX","99 Terrace View Avenue"
2,0,2,"6034aa92-31f4-ea11-b882-24ee9a37d45c","P.S. 138 - M138 - M380 - 75M138 - 508 WEST 153RD STREET","6134aa92-31f4-ea11-b882-24ee9a37d45c",-73944846,40830415,"P.S. 380- MANHATTAN","508 WEST 153RD STREET"
4,0,4,"8d83ff9e-30f4-ea11-b882-24ee9a37d45c","P.S. 247 Brooklyn - K247 - K247 - 20K247 - 7000 21 AVENUE","8e83ff9e-30f4-ea11-b882-24ee9a37d45c",-73987195,40612247,"P.S. 247 - BROOKLYN","7000 21 AVENUE"
2,2,0,"725bc58c-30f4-ea11-b882-24ee9a37d45c","Urban Assembly School for Leadership and Empowerment - K609 - K223 - 20K609 - 4200 16 AVENUE","735bc58c-30f4-ea11-b882-24ee9a37d45c",-73982424,40635100,"I.S. 223 - BROOKLYN","4200 16 AVENUE"
4,4,0,"27eabc42-30f4-ea11-b882-24ee9a37d45c","M.S. 51 William Alexander - K051 - K051 - 15K051 - 350 5 AVENUE","28eabc42-30f4-ea11-b882-24ee9a37d45c",-73985050,40672358,"I.S. 51 - BROOKLYN","350 5 AVENUE"
2,0,2,"1eaf0313-32f4-ea11-b882-24ee9a37d45c","P.S. 136 Roy Wilkins - Q136 - Q136 - 29Q136 - 201-15 115 AVENUE","1faf0313-32f4-ea11-b882-24ee9a37d45c",-73752694,40698940,"P.S. 136 - QUEENS","201-15 115 AVENUE"
2,0,2,"3b2682ef-ebf6-ea11-b883-24ee9a37d459","P.S. 723 - X723 - X099 - 75X723 - 1180 REV. J.A. POLITE AVE.","4a474313-33f4-ea11-b882-24ee9a37d45c",-73896925,40827539,"REV. J.A. POLITE AVE SCHOOL CAMPUS - BRONX","1180 REV. J.A. POLITE AVE."
3,2,1,"f01aad3c-30f4-ea11-b882-24ee9a37d45c","P.S. 031 Samuel F. Dupont - K031 - K031 - 14K031 - 75 MESEROLE AVENUE","f11aad3c-30f4-ea11-b882-24ee9a37d45c",-73954139,40726970,"P.S. 31 (OLD 126) - K","75 MESEROLE AVENUE"
3,0,3,"673cbf01-ebf6-ea11-b883-24ee9a37d459","P.S. X596 - X596 - X178 - 75X596 - 850 BAYCHESTER AVENUE","e38a0044-33f4-ea11-b882-24ee9a37d45c",-73831669,0,"P.S. 178 - BRONX","850 BAYCHESTER AVENUE"
2,0,2,"a88fd48d-ebf6-ea11-b883-24ee9a37d459","P.S. Q224 - Q224 - Q026 - 75Q224 - 195-02 69 AVENUE","c5fc24e8-31f4-ea11-b882-24ee9a37d45c",-73777607,40735935,"P.S. 26 - QUEENS","195-02 69 AVENUE"
2,0,2,"ad9c11e8-30f4-ea11-b882-24ee9a37d45c","High School for Public Service: Heroes of Tomorrow - K546 - K470 - 17K546 - 600 KINGSTON AVENUE","aa9c11e8-30f4-ea11-b882-24ee9a37d45c",-73943839,40658671,"GEORGE W. WINGATE HS - K","600 KINGSTON AVENUE"
2,1,1,"b572c880-32f4-ea11-b882-24ee9a37d45c","P.S. Q016 The Nancy DeBenedittis School - Q016 - Q721 - 24Q016 - 41-15 104 STREET","b672c880-32f4-ea11-b882-24ee9a37d45c",-73860547,40748996,"P.S. 16 (OLD Q721 SPED) - QUEENS","41-15 104 STREET"
1,1,0,"86e657bd-30f4-ea11-b882-24ee9a37d45c","P.S. 312 Bergen Beach - K312 - K312 - 22K312 - 7103 Avenue T","87e657bd-30f4-ea11-b882-24ee9a37d45c",-73909554,40622442,"P.S. 312 - BROOKLYN","7103 Avenue T"
3,3,0,"4a9d7c62-33f4-ea11-b882-24ee9a37d45c","Bronxdale High School - X508 - X415 - 11X508 - 925 ASTOR AVENUE","439d7c62-33f4-ea11-b882-24ee9a37d45c",-73860729,40860443,"CHRISTOPHER COLUMBUS HS - X","925 ASTOR AVENUE"
2,1,1,"43767649-31f4-ea11-b882-24ee9a37d45c","P.S. 033 Chelsea Prep - M033 - M033 - 02M033 - 281 9 AVENUE","42767649-31f4-ea11-b882-24ee9a37d45c",-74000238,40749014,"P.S. 33 - MANHATTAN","281 9 AVENUE"
2,1,1,"4dfdc1bd-32f4-ea11-b882-24ee9a37d45c","P.S. 11 Thomas Dongan School - R011 - R011 - 31R011 - 51 Jefferson Street","4efdc1bd-32f4-ea11-b882-24ee9a37d45c",-74098252,40590887,"P.S. 11 - STATEN ISLAND","51 Jefferson Street"
3,2,1,"081bad3c-30f4-ea11-b882-24ee9a37d45c","P.S. 039 Henry Bristow - K039 - K039 - 15K039 - 417 6 AVENUE","091bad3c-30f4-ea11-b882-24ee9a37d45c",-73982909,40668644,"P.S. 39 - BROOKLYN","417 6 AVENUE"
1,0,1,"b2dbbeb9-274f-ed11-b0b5-088e901ef405","P.S. 001 Tottenville - R001 - R701 - 31R001 - 58 Summit Street","b3dbbeb9-274f-ed11-b0b5-088e901ef405",0,0,"P.S. 1 GYM ANNEX - STATEN ISLAND","58 Summit Street"
1,0,1,"26e0d393-ebf6-ea11-b883-24ee9a37d459","P.S. Q233 - Q233 - Q134 - 75Q233 - 203-02 109 Avenue","10af0313-32f4-ea11-b882-24ee9a37d45c",-73754747,40707535,"P.S. 134 - QUEENS","203-02 109 Avenue"
1,0,1,"37767649-31f4-ea11-b882-24ee9a37d45c","P.S. 138 - M138 - M030 - 75M138 - 144-176 EAST 128 STREET","38767649-31f4-ea11-b882-24ee9a37d45c",-73935461,40805653,"P.S. 30 - MANHATTAN","144-176 EAST 128 STREET"
1,0,1,"240410ca-32f4-ea11-b882-24ee9a37d45c","Naples Street Elementary School - R009 - R048 - 31R009 - 1055 Targee Street","250410ca-32f4-ea11-b882-24ee9a37d45c",-74090245,0,"P.S. 48 - STATEN ISLAND","1055 Targee Street"
1,1,0,"f8ce496e-31f4-ea11-b882-24ee9a37d45c","Castle Bridge School - M513 - M128 - 06M513 - 560 WEST 169 STREET","f9ce496e-31f4-ea11-b882-24ee9a37d45c",-73938701,0,"P.S. 128 - MANHATTAN","560 WEST 169 STREET"
4,0,4,"5af4a0ef-eaf6-ea11-b883-24ee9a37d459","P.S. K771 - K771 - K225 - 75K771 - 1075 OCEAN VIEW AVENUE","e521d292-30f4-ea11-b882-24ee9a37d45c",-73955856,40580260,"P.S. 225 - BROOKLYN","1075 OCEAN VIEW AVENUE"
3,3,0,"52507380-31f4-ea11-b882-24ee9a37d45c","P.S. 183 Robert L. Stevenson - M183 - M183 - 02M183 - 419 East 66 Street","53507380-31f4-ea11-b882-24ee9a37d45c",-73957731,40763804,"P.S. 183 - MANHATTAN","419 East 66 Street"
2,0,2,"0dd1de79-30f4-ea11-b882-24ee9a37d45c","P.S. 177 The Marlboro - K177 - K177 - 21K177 - 346 AVENUE P","0ed1de79-30f4-ea11-b882-24ee9a37d45c",-73974425,40608169,"P.S. 177 - BROOKLYN","346 AVENUE P"
2,2,0,"516e70b7-31f4-ea11-b882-24ee9a37d45c","P.S. 527 - East Side School for Social Action - M527 - M816 - 02M527 - 323 EAST 91 STREET","526e70b7-31f4-ea11-b882-24ee9a37d45c",-73947856,40780652,"P.S. 527 - East Side School for Social Action","323 EAST 91 STREET"
1,0,1,"18e63126-ebf6-ea11-b883-24ee9a37d459","P.S. K771 - K771 - K236 - 75K771 - 6302 AVENUE U","5ba5db98-30f4-ea11-b882-24ee9a37d45c",-73912005,40615494,"P.S. 236 - BROOKLYN","6302 AVENUE U"
3,1,2,"43fdc1bd-32f4-ea11-b882-24ee9a37d45c","I.S. 007 Elias Bernstein - R007 - R007 - 31R007 - 1270 Huguenot Avenue","447c21b7-32f4-ea11-b882-24ee9a37d45c",-74186096,40522971,"I.S. 7 - STATEN ISLAND","1270 Huguenot Avenue"
1,1,0,"6107e99e-31f4-ea11-b882-24ee9a37d45c","Ella Baker School - M225 - M480 - 02M225 - 317 EAST 67 STREET","6007e99e-31f4-ea11-b882-24ee9a37d45c",-73959777,40765638,"JULIA RICHMAN ED. COMPLEX - M","317 EAST 67 STREET"
2,0,2,"2bc73b4a-32f4-ea11-b882-24ee9a37d45c","P.S. 092 Harry T. Stewart Sr. - Q092 - Q292 - 30Q092 - 99-01 34 AVENUE","29c73b4a-32f4-ea11-b882-24ee9a37d45c",-73868773,40755983,"P.S. 92 - QUEENS","99-01 34 AVENUE"
1,0,1,"30c15a75-ebf6-ea11-b883-24ee9a37d459","Adult and Continuing Education - K755 - M827 - 79K755 - 500 8 AVENUE","576e70b7-31f4-ea11-b882-24ee9a37d45c",-73992405,40753038,"AUX. SERV-MAN. LEARNING CENTER - M","500 8 AVENUE"
1,1,0,"89464e91-4afb-ea11-b883-24ee9a37d459","KINGSBRIDGE HEIGHTS COMMUNITY CENTER - XAOT - XAOT -  - 3101 KINGSBRIDGE TERRACE","8a464e91-4afb-ea11-b883-24ee9a37d459",-73900687,40877570,"KINGSBRIDGE HEIGHTS COMMUNITY CENTER","3101 KINGSBRIDGE TERRACE"
3,3,0,"130410ca-32f4-ea11-b882-24ee9a37d45c","CSI High School for International Studies - R047 - R043 - 31R047 - 100 ESSEX DRIVE","a0a9d9c3-32f4-ea11-b882-24ee9a37d45c",-74159343,40581958,"JEROME PARKER CAMPUS - S.I.","100 ESSEX DRIVE"
1,0,1,"983c646f-e21e-eb11-b885-24ee9a37d45c","The David Marquis School of the Arts - R037 - R089 - 75R037 - 15a Fairfield Street","993c646f-e21e-eb11-b885-24ee9a37d45c",-74151375,0,"D75 REPLACEMENT @ 15 FAIRFIELD STREET - S.I.","15a Fairfield Street"
2,0,2,"8801ce37-33f4-ea11-b882-24ee9a37d45c","P.S. 157 Grove Hill - X157 - X157 - 07X157 - 757 CAULDWELL AVENUE","8901ce37-33f4-ea11-b882-24ee9a37d45c",-73908965,40819419,"P.S. 157 - BRONX","757 CAULDWELL AVENUE"
3,1,2,"1412a0be-ebf6-ea11-b883-24ee9a37d459","P.S. Q233 - Q233 - Q875 - 75Q233 - 114-43 142 Street","c3edf392-32f4-ea11-b882-24ee9a37d45c",-73800875,40683473,"P.S. 233 MINISCHOOL2 (OLD P752)-Q","114-43 142 Street"
3,3,0,"bbfab455-31f4-ea11-b882-24ee9a37d45c","James Weldon Johnson - M057 - M057 - 04M057 - 176 EAST 115 STREET","bcfab455-31f4-ea11-b882-24ee9a37d45c",-73941598,40797205,"P.S. 57 - MANHATTAN","176 EAST 115 STREET"
1,0,1,"efe0a4fb-ebf6-ea11-b883-24ee9a37d459","LYFE - M984 - X401 - 79M984 - 1010 REV. J. A. POLITE AVENUE","8ce03d56-33f4-ea11-b882-24ee9a37d45c",-73898265,40823124,"BRONX REGIONAL HS (OLD 133) - X","1010 REV. J. A. POLITE AVENUE"
1,0,1,"6cbe7adc-32f4-ea11-b882-24ee9a37d45c","ALC - ST. Marks Place - R971 - R801 - 88R971 - 450 ST MARKS PLACE","69be7adc-32f4-ea11-b882-24ee9a37d45c",-74077564,40638388,"AUX. SERV - ST. GEORGE SCHOOL-S.I.","450 ST MARKS PLACE"
6,2,4,"f6f57030-30f4-ea11-b882-24ee9a37d45c","P.S. 015 Patrick F. Daly - K015 - K015 - 15K015 - 71 SULLIVAN STREET","f5f57030-30f4-ea11-b882-24ee9a37d45c",-74011864,40677085,"P.S. 15 - BROOKLYN","71 SULLIVAN STREET"
1,0,1,"d7e0a4fb-ebf6-ea11-b883-24ee9a37d459","P.S. X176 - X176 - X181 - 75X176 - 800 BAYCHESTER AVENUE","e78a0044-33f4-ea11-b882-24ee9a37d45c",-73831669,40874035,"I.S. 181 - BRONX","800 BAYCHESTER AVENUE"
3,2,1,"9748b1f5-eaf6-ea11-b883-24ee9a37d459","P.S. 372 -The Children's School - K372 - K834 - 75K372 - 512 CARROLL STREET","fcd7cf12-31f4-ea11-b882-24ee9a37d45c",-73985500,40676198,"P.S. 372 (OUR LADY OF PEACE)-K","512 CARROLL STREET"
2,0,2,"1ceabc42-30f4-ea11-b882-24ee9a37d45c","Lyons Community School - K586 - K049 - 14K586 - 223 GRAHAM AVENUE","14eabc42-30f4-ea11-b882-24ee9a37d45c",-73944463,40709765,"I.S. 49 - BROOKLYN","223 GRAHAM AVENUE"
4,2,2,"d90d3c5b-30f4-ea11-b882-24ee9a37d45c","P.S. 102 The Bayview - K102 - K102 - 20K102 - 211 72 STREET","da0d3c5b-30f4-ea11-b882-24ee9a37d45c",-74028758,40634318,"P.S. 102 - BROOKLYN","211 72 STREET"
4,3,1,"8653dd74-33f4-ea11-b882-24ee9a37d45c","Harry S Truman High School - X455 - X455 - 11X455 - 750 BAYCHESTER AVENUE","8253dd74-33f4-ea11-b882-24ee9a37d45c",-73831669,0,"HARRY S. TRUMAN HS - X","750 BAYCHESTER AVENUE"
4,1,3,"52767649-31f4-ea11-b882-24ee9a37d45c","P.S. 041 Greenwich Village - M041 - M041 - 02M041 - 116 WEST 11 STREET","53767649-31f4-ea11-b882-24ee9a37d45c",-73999094,40735450,"P.S. 41 - MANHATTAN","116 WEST 11 STREET"
4,3,1,"c837fba4-31f4-ea11-b882-24ee9a37d45c","Park East High School - M495 - M495 - 04M495 - 230 EAST 105 STREET","c737fba4-31f4-ea11-b882-24ee9a37d45c",-73944092,40790191,"PARK EAST HS - MANHATTAN","230 EAST 105 STREET"
4,4,0,"cee8ce00-32f4-ea11-b882-24ee9a37d45c","J.H.S. 074 Nathaniel Hawthorne - Q074 - Q074 - 26Q074 - 61-15 Oceania Street","cfe8ce00-32f4-ea11-b882-24ee9a37d45c",-73766653,40744743,"I.S. 74 - QUEENS","61-15 Oceania Street"
1,1,0,"bae0838c-31f4-ea11-b882-24ee9a37d45c","P.S. 234 Independence School - M234 - M234 - 02M234 - 292 GREENWICH STREET","bbe0838c-31f4-ea11-b882-24ee9a37d45c",-74010880,40719530,"P.S. 234 - MANHATTAN","292 GREENWICH STREET"
1,1,0,"7707e99e-31f4-ea11-b882-24ee9a37d45c","P.S. 059 Beekman Hill International - M059 - M488 - 02M059 - 231-249 EAST 56 STREET","6d07e99e-31f4-ea11-b882-24ee9a37d45c",-73967204,40759248,"MIDTOWN EAST CAMPUS - MANHATTAN","231-249 EAST 56 STREET"
1,1,0,"e78442ee-31f4-ea11-b882-24ee9a37d45c","P.S. 041 Crocheron - Q041 - Q041 - 26Q041 - 214-43 35 AVENUE","e58442ee-31f4-ea11-b882-24ee9a37d45c",-73771225,40770155,"P.S. 41 - QUEENS","214-43 35 AVENUE"
2,2,0,"16ba8b86-30f4-ea11-b882-24ee9a37d45c","P.S. 207 Elizabeth G. Leary - K207 - K207 - 22K207 - 4011 FILLMORE AVENUE","17ba8b86-30f4-ea11-b882-24ee9a37d45c",-73930485,40613981,"P.S. 207 - BROOKLYN","4011 FILLMORE AVENUE"
2,1,1,"f9ae0313-32f4-ea11-b882-24ee9a37d45c","P.S. 124 Osmond A Church - Q124 - Q124 - 27Q124 - 129-15 150 AVENUE","faae0313-32f4-ea11-b882-24ee9a37d45c",-73811266,40665669,"P.S. 124 - QUEENS","129-15 150 AVENUE"
1,1,0,"ded27c6d-30f4-ea11-b882-24ee9a37d45c","P.S. 373 - Brooklyn Transition Center - K373 - K148 - 75K373 - 185 ELLERY STREET","dcd27c6d-30f4-ea11-b882-24ee9a37d45c",-73945211,0,"P.S. 373 (OLD P148) - BROOKLYN","185 ELLERY STREET"
2,2,0,"c7ba3c50-33f4-ea11-b882-24ee9a37d45c","P.S. 279 Captain Manuel Rivera, Jr. - X279 - X279 - 10X279 - 2100 WALTON AVENUE","c8ba3c50-33f4-ea11-b882-24ee9a37d45c",-73904958,40854666,"P.S. 279 - BRONX","2100 WALTON AVENUE"
1,0,1,"0a6e3d68-31f4-ea11-b882-24ee9a37d45c","P.S. 112 Jose Celso Barbosa - M112 - M112 - 04M112 - 535 EAST 119 STREET","0b6e3d68-31f4-ea11-b882-24ee9a37d45c",-73930528,40796889,"P.S. 112 (TANDEM M206) - MANHATTAN","535 EAST 119 STREET"
2,1,1,"0878931f-33f4-ea11-b882-24ee9a37d45c","Young Women's Leadership School of the Bronx - X568 - X117 - 09X568 - 1865 MORRIS AVENUE","0578931f-33f4-ea11-b882-24ee9a37d45c",-73909022,40848552,"I.S. 117 - BRONX","1865 MORRIS AVENUE"
1,0,1,"50fdc1bd-32f4-ea11-b882-24ee9a37d45c","P.S. 013 M. L. Lindemeyer - R013 - R013 - 31R013 - 191 VERMONT AVENUE","51fdc1bd-32f4-ea11-b882-24ee9a37d45c",-74068963,0,"P.S. 13 - STATEN ISLAND","191 VERMONT AVENUE"
1,1,0,"aefc24e8-31f4-ea11-b882-24ee9a37d45c","P.S. 021 Edward Hart - Q021 - Q021 - 25Q021 - 147-36 26 AVENUE","adfc24e8-31f4-ea11-b882-24ee9a37d45c",-73818581,40774134,"P.S. 21 - QUEENS","147-36 26 AVENUE"
1,1,0,"6c977d2b-32f4-ea11-b882-24ee9a37d45c","P.S. 188 Kingsbury - Q188 - Q188 - 26Q188 - 218-12 HARTLAND AVENUE","6d977d2b-32f4-ea11-b882-24ee9a37d45c",-73753985,40736063,"P.S. 188 - QUEENS","218-12 HARTLAND AVENUE"
3,0,3,"e621d292-30f4-ea11-b882-24ee9a37d45c","P.S. K225 - The Eileen E. Zaglin - K225 - K225 - 21K225 - 1075 OCEAN VIEW AVENUE","e521d292-30f4-ea11-b882-24ee9a37d45c",-73955856,40580260,"P.S. 225 - BROOKLYN","1075 OCEAN VIEW AVENUE"
4,3,1,"626e70b7-31f4-ea11-b882-24ee9a37d45c","High School for Environmental Studies - M400 - M834 - 02M400 - 444 WEST 56 STREET","5d6e70b7-31f4-ea11-b882-24ee9a37d45c",-73988610,40767848,"HS FOR ENVIRONMENTAL STUDIES - M","444 WEST 56 STREET"
2,2,0,"b3fc24e8-31f4-ea11-b882-24ee9a37d45c","P.S. 022 Thomas Jefferson - Q022 - Q022 - 25Q022 - 153-33 SANFORD AVENUE","b1fc24e8-31f4-ea11-b882-24ee9a37d45c",-73811373,40761744,"P.S. 22 - QUEENS","153-33 SANFORD AVENUE"
1,0,1,"e2e0a4fb-ebf6-ea11-b883-24ee9a37d459","P.S. X010 - X010 - X240 - 75X010 - 1501 JEROME AVENUE","baba3c50-33f4-ea11-b882-24ee9a37d45c",-73916084,40842503,"DOE NEW SETTLEMENT COMMUNITY CAMPUS - X","1501 JEROME AVENUE"
1,0,1,"51ffcc6e-33f4-ea11-b882-24ee9a37d45c","Bronx Collaborative High School - X351 - X440 - 10X351 - 100 WEST MOSHOLU PARKWAY SOUTH","4cffcc6e-33f4-ea11-b882-24ee9a37d45c",-73889011,40879958,"DEWITT CLINTON HS - X","100 WEST MOSHOLU PARKWAY SOUTH"
3,3,0,"4b6e70b7-31f4-ea11-b882-24ee9a37d45c","High School for Mathematics, Science and Engineering at City College - M692 - M812 - 05M692 - 240 CONVENT AVE","4c6e70b7-31f4-ea11-b882-24ee9a37d45c",-73950354,0,"HS FOR MATH, SCI & ENGINEERING-M","240 CONVENT AVE"
5,5,0,"96d91731-31f4-ea11-b882-24ee9a37d45c","Brooklyn Urban Garden Charter School - K758 - KBNU - 84K758 - 500 19 Street","97d91731-31f4-ea11-b882-24ee9a37d45c",-73982624,0,"STANLEY LAMM INSTITUE PRE-SCHOOL OF LONGISLAND HO","500 19 Street"
1,1,0,"ecba3c50-33f4-ea11-b882-24ee9a37d45c","P.S. 340 - X340 - X340 - 10X340 - 25 WEST 195 STREET","edba3c50-33f4-ea11-b882-24ee9a37d45c",-73897171,0,"P.S. 340 - BRONX","25 WEST 195 STREET"
3,3,0,"1202926e-32f4-ea11-b882-24ee9a37d45c","Queens High School for Information, Research, and Technology - Q302 - Q465 - 27Q302 - 8-21 BAY 25 STREET","0b02926e-32f4-ea11-b882-24ee9a37d45c",-73763995,40601537,"FAR ROCKAWAY HS - Q","8-21 BAY 25 STREET"
1,0,1,"cb689025-33f4-ea11-b882-24ee9a37d45c","Soundview Academy for Culture and Scholarship - X448 - X131 - 08X448 - 885 Bolton Avenue","c8689025-33f4-ea11-b882-24ee9a37d45c",-73859998,0,"I.S. 131 - BRONX","885 Bolton Avenue"
2,2,0,"6f283fb1-30f4-ea11-b882-24ee9a37d45c","I.S. 285 Meyer Levin - K285 - K285 - 18K285 - 5909 BEVERLY ROAD","70283fb1-30f4-ea11-b882-24ee9a37d45c",-73920784,40647818,"I.S. 285 - BROOKLYN","5909 BEVERLY ROAD"
14,11,3,"ace657bd-30f4-ea11-b882-24ee9a37d45c","P.S. 321 William Penn - K321 - K321 - 15K321 - 180 7 AVENUE","ade657bd-30f4-ea11-b882-24ee9a37d45c",-73978633,40671816,"P.S. 321 - BROOKLYN","180 7 AVENUE"
1,0,1,"12ae38fc-7001-ed11-b8db-24ee9a37d45c","The Richard H. Hungerford School - R721 - R086 - 75R721 - 715 L Ocean Terrace","713f38e4-e9e5-ec11-b8d9-24ee9a37d45c",-74108045,40608374,"I.S./H.S. @ 715L OCEAN TERRACE - STATEN ISLAND","715 L Ocean Terrace"
1,0,1,"8f28a20c-31f4-ea11-b882-24ee9a37d45c","P.S. 373 - Brooklyn Transition Center - K373 - K804 - 75K373 - 347 Baltic Street","9028a20c-31f4-ea11-b882-24ee9a37d45c",-73990884,40684869,"COBBLE HILL SCL OF AMR STD (OL6)-K","347 Baltic Street"
1,0,1,"9ebfa431-33f4-ea11-b882-24ee9a37d45c","South Bronx International Middle School - X593 - X145 - 09X593 - 1000 TELLER AVENUE","9abfa431-33f4-ea11-b882-24ee9a37d45c",-73914067,40827438,"I.S. 145 - BRONX","1000 TELLER AVENUE"
1,0,1,"34e85c61-30f4-ea11-b882-24ee9a37d45c","P.S. 116 Elizabeth L Farrell - K116 - K116 - 32K116 - 515 KNICKERBOCKER AVENUE","35e85c61-30f4-ea11-b882-24ee9a37d45c",-73916563,40698077,"P.S. 116 - BROOKLYN","515 KNICKERBOCKER AVENUE"
1,0,1,"4002fdd0-ebf6-ea11-b883-24ee9a37d459","The Richard H. Hungerford School - R721 - R024 - 75R721 - 750 DURANT AVENUE","5bfdc1bd-32f4-ea11-b882-24ee9a37d45c",-74145558,40545490,"I.S. 24 - STATEN ISLAND","750 DURANT AVENUE"
1,0,1,"fdd0de79-30f4-ea11-b882-24ee9a37d45c","P.S. 172 Beacon School of Excellence - K172 - K172 - 15K172 - 825 4 AVENUE","fed0de79-30f4-ea11-b882-24ee9a37d45c",-74000191,40657682,"P.S. 172 - BROOKLYN","825 4 AVENUE"
1,1,0,"cd79df48-30f4-ea11-b882-24ee9a37d45c","P.S. 66 - K066 - K066 - 18K066 - 845 EAST 96 STREET","cc79df48-30f4-ea11-b882-24ee9a37d45c",-73907064,40648749,"P.S. 66 - BROOKLYN","845 EAST 96 STREET"
3,3,0,"2e005d7a-31f4-ea11-b882-24ee9a37d45c","Mott Hall II - M862 - M165 - 03M862 - 234 West 109 Street","2f005d7a-31f4-ea11-b882-24ee9a37d45c",-73965949,40802653,"P.S. 165 - MANHATTAN","234 West 109 Street"
4,3,1,"e68521d0-32f4-ea11-b882-24ee9a37d45c","I.S. 075 Frank D. Paulo - R075 - R075 - 31R075 - 455 HUGUENOT AVENUE","e28521d0-32f4-ea11-b882-24ee9a37d45c",-74197033,40544535,"I.S. 75 - STATEN ISLAND","455 HUGUENOT AVENUE"
3,2,1,"99d810ab-31f4-ea11-b882-24ee9a37d45c","Chelsea Career and Technical Education High School - M615 - M615 - 02M615 - 131 AVENUE OF THE AMERICAS","9ad810ab-31f4-ea11-b882-24ee9a37d45c",-74005058,0,"CHELSEA VOC HS - MANHATTAN","131 AVENUE OF THE AMERICAS"
2,2,0,"9cd810ab-31f4-ea11-b882-24ee9a37d45c","NYC iSchool - M376 - M615 - 02M376 - 131 AVENUE OF THE AMERICAS","9ad810ab-31f4-ea11-b882-24ee9a37d45c",-74005058,0,"CHELSEA VOC HS - MANHATTAN","131 AVENUE OF THE AMERICAS"
1,1,0,"aaeb6056-32f4-ea11-b882-24ee9a37d45c","The Hector Figueroa School - Q398 - Q398 - 30Q398 - 69-01 34TH AVENUE","abeb6056-32f4-ea11-b882-24ee9a37d45c",-73896705,0,"P.S. 398 - QUEENS","69-01 34TH AVENUE"
3,1,2,"299ebaee-32f4-ea11-b882-24ee9a37d45c","P.S. X014 Senator John Calandra - X014 - X014 - 08X014 - 3047 BRUCKNER BOULEVARD","2a9ebaee-32f4-ea11-b882-24ee9a37d45c",-73826277,40835318,"P.S. 14 - BRONX","3047 BRUCKNER BOULEVARD"
4,2,2,"26c73b4a-32f4-ea11-b882-24ee9a37d45c","A.C.E. Academy for Scholars at the Geraldine Ferraro Campus - Q290 - Q290 - 24Q290 - 55-20 METROPOLITAN AVENUE","24c73b4a-32f4-ea11-b882-24ee9a37d45c",-73908307,40713030,"THE GERALDINE FERRARO CAMPUS - QUEENS","55-20 METROPOLITAN AVENUE"
3,1,2,"5907e99e-31f4-ea11-b882-24ee9a37d45c","High School for Health Professions and Human Services - M420 - M475 - 02M420 - 345 East 15th Street","5607e99e-31f4-ea11-b882-24ee9a37d45c",-73982590,40732665,"HEALTH PROFESSIONS HS (OL STY) - M","345 East 15th Street"
1,1,0,"df883319-32f4-ea11-b882-24ee9a37d45c","P.S. 144 Col Jeromus Remsen - Q144 - Q144 - 28Q144 - 69-20 JUNO STREET","e0883319-32f4-ea11-b882-24ee9a37d45c",-73852398,40714890,"P.S. 144 - QUEENS","69-20 JUNO STREET"
3,2,1,"37a6ba98-31f4-ea11-b882-24ee9a37d45c","Innovation Diploma Plus - M404 - M470 - 03M404 - 145 WEST 84 STREET","33a6ba98-31f4-ea11-b882-24ee9a37d45c",-73974483,40786134,"LOUIS D. BRANDEIS HS - MANHATTAN","145 WEST 84 STREET"
1,0,1,"9ee657bd-30f4-ea11-b882-24ee9a37d45c","I.S. 318 Eugenio Maria De Hostos - K318 - K318 - 14K318 - 101 WALTON STREET","9de657bd-30f4-ea11-b882-24ee9a37d45c",-73948771,40703034,"I.S. 318 - BROOKLYN","101 WALTON STREET"
2,1,1,"ddfab455-31f4-ea11-b882-24ee9a37d45c","N.Y.C. Lab School for Collaborative Studies - M412 - M070 - 02M412 - 333 WEST 17 STREET","defab455-31f4-ea11-b882-24ee9a37d45c",-74002222,40742512,"I.S. 70 - MANHATTAN","333 WEST 17 STREET"
2,1,1,"b669c231-32f4-ea11-b882-24ee9a37d45c","P.S. 209 Clearview Gardens - Q209 - Q209 - 25Q209 - 16-10 Utopia Parkway","b569c231-32f4-ea11-b882-24ee9a37d45c",-73795845,40783777,"P.S. 209 - QUEENS","16-10 Utopia Parkway"
4,2,2,"cf0d3c5b-30f4-ea11-b882-24ee9a37d45c","P.S. 099 Isaac Asimov - K099 - K099 - 21K099 - 1120 EAST 10 STREET","d00d3c5b-30f4-ea11-b882-24ee9a37d45c",-73966031,40621474,"P.S. 99 - BROOKLYN","1120 EAST 10 STREET"
3,2,1,"f6d10307-33f4-ea11-b882-24ee9a37d45c","P.S. 072 Dr. William Dorney - X072 - X072 - 08X072 - 2951 DEWEY AVENUE","f4d10307-33f4-ea11-b882-24ee9a37d45c",-73818172,40823237,"P.S. 72 - BRONX","2951 DEWEY AVENUE"
1,0,1,"c08442ee-31f4-ea11-b882-24ee9a37d45c","P.S. 029 Queens - Q029 - Q029 - 25Q029 - 125-10 23 AVENUE","c18442ee-31f4-ea11-b882-24ee9a37d45c",-73842967,40778029,"P.S. 29 - QUEENS","125-10 23 AVENUE"
2,1,1,"8a41e65b-31f4-ea11-b882-24ee9a37d45c","P.S. 084 Lillian Weber - M084 - M084 - 03M084 - 32 West 92 Street","8b41e65b-31f4-ea11-b882-24ee9a37d45c",-73968419,40789479,"P.S. 84 - MANHATTAN","32 West 92 Street"
2,1,1,"c0e0838c-31f4-ea11-b882-24ee9a37d45c","East Side Elementary School, PS 267 - M267 - M267 - 02M267 - 213 EAST 63RD STREET","c1e0838c-31f4-ea11-b882-24ee9a37d45c",-73963861,40763883,"P.S. 59 - (MEETH) -MANHATTAN","213 EAST 63RD STREET"
6,6,0,"df8521d0-32f4-ea11-b882-24ee9a37d45c","P.S. 048 William G. Wilcox - R048 - R071 - 31R048 - 1050 Targee Street","db8521d0-32f4-ea11-b882-24ee9a37d45c",-74091239,40603492,"P.S./I.S. 48 - Staten Island","1050 Targee Street"
1,1,0,"9553dd74-33f4-ea11-b882-24ee9a37d45c","University Heights Secondary School - X495 - X470 - 07X495 - 701 ST. ANNS AVENUE","9253dd74-33f4-ea11-b882-24ee9a37d45c",-73911633,40818041,"SOUTH BRONX EDUCATIONAL CAMPUS (OLD 38) - X","701 ST. ANNS AVENUE"
1,0,1,"45507380-31f4-ea11-b882-24ee9a37d45c","Muscota - M314 - M176 - 06M314 - 4862 BROADWAY","46507380-31f4-ea11-b882-24ee9a37d45c",-73923818,40866381,"P.S./I.S. 176 - MANHATTAN","4862 BROADWAY"
1,1,0,"eefa079f-32f4-ea11-b882-24ee9a37d45c","P.S. 146 Howard Beach - Q146 - Q987 - 27Q146 - 98-01 159 Avenue","effa079f-32f4-ea11-b882-24ee9a37d45c",-73834896,40660531,"P.S. 146 TRANSPORTABLE - Q","98-01 159 Avenue"
3,3,0,"538dbfcf-30f4-ea11-b882-24ee9a37d45c","Abraham Lincoln High School - K410 - K410 - 21K410 - 2800 OCEAN PARKWAY","518dbfcf-30f4-ea11-b882-24ee9a37d45c",-73968733,40582627,"ABRAHAM LINCOLN HS - K","2800 OCEAN PARKWAY"
4,3,1,"7e8d8486-31f4-ea11-b882-24ee9a37d45c","P.S. 198 Isador E. Ida Straus - M198 - M198 - 02M198 - 1700 3 AVENUE","7f8d8486-31f4-ea11-b882-24ee9a37d45c",-73950420,0,"P.S. 198 - MANHATTAN","1700 3 AVENUE"
1,0,1,"ed8442ee-31f4-ea11-b882-24ee9a37d45c","P.S. Q256 - Q256 - Q043 - 75Q256 - 160 BEACH 29 STREET","ee8442ee-31f4-ea11-b882-24ee9a37d45c",-73761086,40593480,"P.S. 43 - QUEENS","160 BEACH 29 STREET"
1,1,0,"6ea5db98-30f4-ea11-b882-24ee9a37d45c","Andries Hudde - K240 - K240 - 22K240 - 2500 NOSTRAND AVENUE","69a5db98-30f4-ea11-b882-24ee9a37d45c",-73946836,40623788,"I.S. 240 - BROOKLYN","2500 NOSTRAND AVENUE"
3,3,0,"c52ff20c-32f4-ea11-b882-24ee9a37d45c","P.S./I.S. 113 Anthony J. Pranzo - Q113 - Q113 - 24Q113 - 78-23 87TH STREET","c62ff20c-32f4-ea11-b882-24ee9a37d45c",-73861493,40705476,"P.S./I.S. 113 - QUEENS","78-23 87TH STREET"
2,0,2,"179ebaee-32f4-ea11-b882-24ee9a37d45c","Milton Fein School - X007 - X007 - 10X007 - 3201 KINGSBRIDGE AVENUE","189ebaee-32f4-ea11-b882-24ee9a37d45c",-73905697,40881562,"P.S. 7 - BRONX","3201 KINGSBRIDGE AVENUE"
1,1,0,"d3ba3c50-33f4-ea11-b882-24ee9a37d45c","P.S. 306 - X306 - X306 - 10X306 - 40 WEST TREMONT AVENUE","c0ba3c50-33f4-ea11-b882-24ee9a37d45c",-73910827,40850722,"P.S. 306 - BRONX","40 WEST TREMONT AVENUE"
1,1,0,"d611f898-32f4-ea11-b882-24ee9a37d45c","Renaissance Charter School - Q705 - Q885 - 84Q705 - 35-59 81ST STREET","d511f898-32f4-ea11-b882-24ee9a37d45c",-73884817,40749934,"RENAISSANCE CHARTER SCHOOL - Q","35-59 81ST STREET"
1,1,0,"3d0410ca-32f4-ea11-b882-24ee9a37d45c","P.S. 56 The Louis Desario School - R056 - R056 - 31R056 - 250 KRAMER AVENUE","3e0410ca-32f4-ea11-b882-24ee9a37d45c",-74213943,40541856,"P.S. 56 - STATEN ISLAND","250 KRAMER AVENUE"
4,3,1,"dae0838c-31f4-ea11-b882-24ee9a37d45c","M.S. 297 - M297 - M323 - 02M297 - 75 MORTON STREET","d8e0838c-31f4-ea11-b882-24ee9a37d45c",-74007192,40731006,"75 Morton Campus","75 MORTON STREET"
6,6,0,"2a8dbfcf-30f4-ea11-b882-24ee9a37d45c","P.S. 109 - K109 - K395 - 22K109 - 1001 EAST 45 STREET","2fe2abc9-30f4-ea11-b882-24ee9a37d45c",-73933099,40635842,"P.S./I.S. 395 - BROOKLYN","1001 EAST 45 STREET"
1,1,0,"7136d900-33f4-ea11-b882-24ee9a37d45c","P.S. 057 Crescent - X057 - X057 - 12X057 - 2111 CROTONA AVENUE","6c36d900-33f4-ea11-b882-24ee9a37d45c",-73888987,40848748,"P.S. 57 - BRONX","2111 CROTONA AVENUE"
2,0,2,"df8442ee-31f4-ea11-b882-24ee9a37d45c","P.S. 038 Rosedale - Q038 - Q038 - 29Q038 - 135-21 241 STREET","e08442ee-31f4-ea11-b882-24ee9a37d45c",-73733774,40671150,"P.S. 38 - QUEENS","135-21 241 STREET"
3,1,2,"0ba198c3-30f4-ea11-b882-24ee9a37d45c","Hyde Leadership Charter School - Brooklyn - K769 - K328 - 84K769 - 330 ALABAMA AVENUE","0ca198c3-30f4-ea11-b882-24ee9a37d45c",-73898249,40667985,"P.S. 328 - BROOKLYN","330 ALABAMA AVENUE"
2,2,0,"07fc3df4-30f4-ea11-b882-24ee9a37d45c","John Dewey High School - K540 - K540 - 21K540 - 50 AVENUE X","05fc3df4-30f4-ea11-b882-24ee9a37d45c",-73981925,40588070,"JOHN DEWEY HS - K","50 AVENUE X"
2,2,0,"d79b4c1f-32f4-ea11-b882-24ee9a37d45c","P.S. 150 Queens - Q150 - Q150 - 30Q150 - 40-01 43 AVENUE","d89b4c1f-32f4-ea11-b882-24ee9a37d45c",-73923375,40745887,"P.S. 150 - QUEENS","40-01 43 AVENUE"
1,0,1,"a7e657bd-30f4-ea11-b882-24ee9a37d45c","P.S. 375 Jackie Robinson School - K375 - K320 - 17K375 - 46 MCKEEVER PLACE","a1e657bd-30f4-ea11-b882-24ee9a37d45c",-73959484,40665199,"P.S. 375 - BROOKLYN","46 MCKEEVER PLACE"
5,5,0,"d8e8ce00-32f4-ea11-b882-24ee9a37d45c","P.S. 079 Francis Lewis - Q079 - Q079 - 25Q079 - 147-27 15 DRIVE","d7e8ce00-32f4-ea11-b882-24ee9a37d45c",-73817338,40786201,"P.S. 79 - QUEENS","147-27 15 DRIVE"
2,1,1,"94283fb1-30f4-ea11-b882-24ee9a37d45c","Digital Arts and Cinema Technology High School - K429 - K293 - 15K429 - 284 Baltic Street","91283fb1-30f4-ea11-b882-24ee9a37d45c",-73993293,40685006,"J.H.S. 293 - BROOKLYN","284 Baltic Street"
1,1,0,"ba9c11e8-30f4-ea11-b882-24ee9a37d45c","The Academy of Urban Planning and Engineering - K552 - K480 - 32K552 - 400 IRVING AVENUE","b39c11e8-30f4-ea11-b882-24ee9a37d45c",-73911751,40696457,"BUSHWICK EDUCATIONAL CAMPUS - K","400 IRVING AVENUE"
1,0,1,"0f01adc5-83ef-eb11-b8b1-24ee9a37d45c","P.S. Q004 - Q004 - Q070 - 75Q004 - 30-44 43rd Street","7b2f77fa-31f4-ea11-b882-24ee9a37d45c",-73913964,40761762,"P.S. 70 - QUEENS","30-44 43rd Street"
2,2,0,"b6315367-30f4-ea11-b882-24ee9a37d45c","P.S. 120 Carlos Tapia - K120 - K120 - 14K120 - 18 Beaver Street","b2315367-30f4-ea11-b882-24ee9a37d45c",-73937888,40700819,"P.S. 120 - BROOKLYN","18 Beaver Street"
2,0,2,"1ae2abc9-30f4-ea11-b882-24ee9a37d45c","P.S. 380 John Wayne Elementary - K380 - K380 - 14K380 - 370 MARCY AVENUE","19e2abc9-30f4-ea11-b882-24ee9a37d45c",-73953702,40701790,"P.S. 380 - BROOKLYN","370 MARCY AVENUE"
1,0,1,"a183ff9e-30f4-ea11-b882-24ee9a37d45c","P.S. 253 - K253 - K253 - 21K253 - 601 OCEANVIEW AVENUE","a283ff9e-30f4-ea11-b882-24ee9a37d45c",-73961962,40580237,"P.S. 253 - BROOKLYN","601 OCEANVIEW AVENUE"
1,1,0,"4ede5eb7-30f4-ea11-b882-24ee9a37d45c","I.S. 303 Herbert S. Eisenberg - K303 - K303 - 21K303 - 501 WEST AVENUE","4cde5eb7-30f4-ea11-b882-24ee9a37d45c",-73972009,40582518,"I.S. 303 - BROOKLYN","521 WEST AVENUE"
1,1,0,"af0e6e25-32f4-ea11-b882-24ee9a37d45c","P.S. 184 Flushing Manor - Q184 - Q184 - 25Q184 - 163-15 21 ROAD","b00e6e25-32f4-ea11-b882-24ee9a37d45c",-73799158,40778334,"P.S. 184 - QUEENS","163-15 21 ROAD"
2,1,1,"419587f5-ebf6-ea11-b883-24ee9a37d459","P.S. X596 - X596 - X153 - 75X596 - 650 BAYCHESTER AVENUE","6801ce37-33f4-ea11-b882-24ee9a37d45c",-73831669,40874035,"P.S. 153 - BRONX","650 BAYCHESTER AVENUE"
1,0,1,"0206003e-32f4-ea11-b882-24ee9a37d45c","The Ivan Lafayette Early Childhood School of the Arts - Q228 - Q228 - 30Q228 - 32-63 93 STREET","0306003e-32f4-ea11-b882-24ee9a37d45c",-73874947,40756931,"P.S. 228 (ECC) - QUEENS","32-63 93 STREET"
1,0,1,"bd0d3c5b-30f4-ea11-b882-24ee9a37d45c","P.S. 094 The Henry Longfellow - K094 - K094 - 15K094 - 5010 6 AVENUE","8fd92255-30f4-ea11-b882-24ee9a37d45c",-74008795,40643730,"P.S. 94 - BROOKLYN","5010 6 AVENUE"
1,0,1,"f991111a-ebf6-ea11-b883-24ee9a37d459","Adult and Continuing Education - K755 - K120 - 79K755 - 18 Beaver Street","b2315367-30f4-ea11-b882-24ee9a37d45c",-73937888,40700819,"P.S. 120 - BROOKLYN","18 Beaver Street"
3,3,0,"2cff3d8d-33f4-ea11-b882-24ee9a37d45c","Health Opportunities High School - X670 - X884 - 07X670 - 350 Gerard Avenue","2dff3d8d-33f4-ea11-b882-24ee9a37d45c",-73929960,40815712,"HEALTH OPPORTUNITIES HS - X","350 Gerard Avenue"
1,0,1,"81a5db98-30f4-ea11-b882-24ee9a37d45c","P.S. 244 Richard R. Green - K244 - K244 - 18K244 - 5404 TILDEN AVENUE","7fa5db98-30f4-ea11-b882-24ee9a37d45c",-73925592,40647851,"P.S. 244 - BROOKLYN","5404 TILDEN AVENUE"
4,3,1,"03b7c337-32f4-ea11-b882-24ee9a37d45c","J.H.S. 216 George J. Ryan - Q216 - Q216 - 26Q216 - 64-20 175 Street","04b7c337-32f4-ea11-b882-24ee9a37d45c",-73794501,40737188,"J.H.S. 216 - QUEENS","64-20 175 Street"
1,0,1,"dc45b178-f27b-ed11-b0c6-088e901ef405","Bronx Bridges High School - X432 - X451 - 08X432 - 1980 Lafayette Avenue","92903f00-f27b-ed11-b0c6-088e901ef405",-73855930,40821218,"STEVENSON AF - BRONX","1980 Lafayette Avenue"
3,1,2,"aa778cb8-ebf6-ea11-b883-24ee9a37d459","P.S. Q233 - Q233 - Q650 - 75Q233 - 94-06 104TH STREET","8f72c880-32f4-ea11-b882-24ee9a37d45c",-73841475,40689177,"HS FOR CONST.TRADES,ENGG.,& ARCH-Q","94-06 104TH STREET"
4,0,4,"307eed06-32f4-ea11-b882-24ee9a37d45c","P.S. 097 Forest Park - Q097 - Q097 - 27Q097 - 85-52 85 STREET","317eed06-32f4-ea11-b882-24ee9a37d45c",-73860031,40694232,"P.S. 97 - QUEENS","85-52 85 STREET"
1,0,1,"827e21a6-ebf6-ea11-b883-24ee9a37d459","P.S. Q004 - Q004 - Q270 - 75Q004 - 233-15 MERRICK BOULEVARD","52a10a44-32f4-ea11-b882-24ee9a37d45c",-73736232,40675070,"P.S. 270 - QUEENS","233-15 MERRICK BOULEVARD"
18,18,0,"87e2635c-32f4-ea11-b882-24ee9a37d45c","Benjamin N. Cardozo High School - Q415 - Q415 - 26Q415 - 57-00 223RD STREET","86e2635c-32f4-ea11-b882-24ee9a37d45c",-73757271,0,"BENJAMIN N. CARDOZO HS - Q","57-00 223RD STREET"
2,0,2,"5ca5db98-30f4-ea11-b882-24ee9a37d45c","P.S. 236 Mill Basin - K236 - K236 - 22K236 - 6302 AVENUE U","5ba5db98-30f4-ea11-b882-24ee9a37d45c",-73912005,40615494,"P.S. 236 - BROOKLYN","6302 AVENUE U"
2,0,2,"998a43a5-f81e-eb11-b885-24ee9a37d45c","D13 REC @ 19 Dock Street - KC03 - K611 -  - 19 DOCK STREET","f03159fa-30f4-ea11-b882-24ee9a37d45c",-73992076,40702952,"DOCK ST CAMPUS - BROOKLYN","25 DOCK STREET"
23,18,5,"3088e6db-30f4-ea11-b882-24ee9a37d45c","Brooklyn Technical High School - K430 - K430 - 13K430 - 29 FT GREENE PLACE","3188e6db-30f4-ea11-b882-24ee9a37d45c",-73976435,40688896,"BROOKLYN TECH HS - K","29 FT GREENE PLACE"
3,2,1,"2da198c3-30f4-ea11-b882-24ee9a37d45c","P.S. 345 Patrolman Robert Bolden - K345 - K345 - 19K345 - 111 BERRIMAN STREET","2ca198c3-30f4-ea11-b882-24ee9a37d45c",-73879886,40676207,"P.S. 345 - BROOKLYN","111 BERRIMAN STREET"
1,1,0,"c3e0838c-31f4-ea11-b882-24ee9a37d45c","P.S./I.S. 217 Roosevelt Island - M217 - M271 - 02M217 - 645 MAIN STREET","b8e0838c-31f4-ea11-b882-24ee9a37d45c",-73956435,40753598,"P.S./I.S. 217 - MANHATTAN","645 MAIN STREET"
1,0,1,"e6454b50-32f4-ea11-b882-24ee9a37d45c","Queens Explorers Elementary School - Q316 - Q316 - 27Q316 - 90-07 101ST AVENUE","e7454b50-32f4-ea11-b882-24ee9a37d45c",-73850123,0,"THE OZONE PARK EDUCATIONAL CAMPUS - QUEENS","90-07 101ST AVENUE"
1,1,0,"716e70b7-31f4-ea11-b882-24ee9a37d45c","P.S. 234 Independence School - M234 - M843 - 02M234 - 200 Chambers Street","726e70b7-31f4-ea11-b882-24ee9a37d45c",-74012351,40716546,"P.S. 234 ANNEX - MANHATTAN","200 Chambers Street"
1,1,0,"b269c231-32f4-ea11-b882-24ee9a37d45c","P.S./I.S. 208 - Q208 - Q208 - 29Q208 - 74-30 COMMONWEALTH BLVD","ab69c231-32f4-ea11-b882-24ee9a37d45c",-73727632,40744276,"P.S./I.S. 208 - QUEENS","74-30 COMMONWEALTH BLVD"
1,0,1,"7e07e99e-31f4-ea11-b882-24ee9a37d45c","The Maxine Greene HS for Imaginative Inquiry - M299 - M490 - 03M299 - 122 AMSTERDAM AVENUE","7c07e99e-31f4-ea11-b882-24ee9a37d45c",-73985608,40774891,"MARTIN LUTHER KING, JR. HS - M","122 AMSTERDAM AVENUE"
5,4,1,"1eb4977a-32f4-ea11-b882-24ee9a37d45c","Townsend Harris High School - Q525 - Q515 - 25Q525 - 149-11 MELBOURNE AVENUE","1db4977a-32f4-ea11-b882-24ee9a37d45c",-73821532,40737038,"TOWNSEND HARRIS HS - Q","149-11 MELBOURNE AVENUE"
1,0,1,"1c1bad3c-30f4-ea11-b882-24ee9a37d45c","P.S./I.S. 045 Horace E. Greene - K045 - K045 - 32K045 - 84 SCHAEFER STREET","1d1bad3c-30f4-ea11-b882-24ee9a37d45c",-73910430,40686424,"P.S. 45 - BROOKLYN","84 SCHAEFER STREET"
1,0,1,"5b5b4cd6-32f4-ea11-b882-24ee9a37d45c","Curtis High School - R450 - R450 - 31R450 - 105 HAMILTON AVENUE","5a5b4cd6-32f4-ea11-b882-24ee9a37d45c",-74082149,40645436,"CURTIS HS - S. I.","105 HAMILTON AVENUE"
3,3,0,"c20d3c5b-30f4-ea11-b882-24ee9a37d45c","P.S. 095 The Gravesend - K095 - K095 - 21K095 - 345 VAN SICKLEN STREET","c30d3c5b-30f4-ea11-b882-24ee9a37d45c",-73974664,40595996,"P.S. 95 - BROOKLYN","345 VAN SICKLEN STREET"
3,3,0,"18af1f69-ebf6-ea11-b883-24ee9a37d459","Special Music School - M859 - M490 - 03M859 - 122 AMSTERDAM AVENUE","7c07e99e-31f4-ea11-b882-24ee9a37d45c",-73985608,40774891,"MARTIN LUTHER KING, JR. HS - M","122 AMSTERDAM AVENUE"
4,4,0,"1cba8b86-30f4-ea11-b882-24ee9a37d45c","P.S. 209 Margaret Mead - K209 - K209 - 21K209 - 2609 EAST 7 STREET","1dba8b86-30f4-ea11-b882-24ee9a37d45c",-73961191,40586800,"P.S. 209 - BROOKLYN","2609 EAST 7 STREET"
3,1,2,"4febaa73-30f4-ea11-b882-24ee9a37d45c","New Bridges Elementary - K532 - K167 - 17K532 - 1025 EASTERN PARKWAY","4cebaa73-30f4-ea11-b882-24ee9a37d45c",-73934316,40669557,"P.S. 167 - BROOKLYN","1025 EASTERN PARKWAY"
1,0,1,"cb9452e9-8b23-ed11-b0a2-088e901ef405","P.S. Q224 - Q224 - Q314 - 75Q224 - 88-08 164TH STREET","d5454b50-32f4-ea11-b882-24ee9a37d45c",-73797981,40708698,"P.S./ I.S. 314 - Queens","88-08 164TH STREET"
2,0,2,"cbe8ce00-32f4-ea11-b882-24ee9a37d45c","I.S. 73 - The Frank Sansivieri Intermediate School - Q073 - Q073 - 24Q073 - 70-02 54 AVENUE","cce8ce00-32f4-ea11-b882-24ee9a37d45c",-73893318,40728558,"I.S. 73 - QUEENS","70-02 54 AVENUE"
2,1,1,"1f005d7a-31f4-ea11-b882-24ee9a37d45c","P.S. 158 Bayard Taylor - M158 - M158 - 02M158 - 1458 YORK AVENUE","1d005d7a-31f4-ea11-b882-24ee9a37d45c",-73950745,40770215,"P.S. 158 - MANHATTAN","1458 YORK AVENUE"
2,0,2,"31bdc8e1-49fb-ea11-b883-24ee9a37d459","Brevoort Children's Center - KASC - KASC -  - 250 RALPH AVENUE","32bdc8e1-49fb-ea11-b883-24ee9a37d459",-73923882,40680384,"BREVOORT CHILDREN'S CENTER","250 RALPH AVENUE"
2,0,2,"91e657bd-30f4-ea11-b882-24ee9a37d45c","P.S. 506: The School of Journalism & Technology - K506 - K314 - 20K506 - 330 59 Street","8ee657bd-30f4-ea11-b882-24ee9a37d45c",-74019299,40641950,"P.S. 314 - BROOKLYN","330 59 Street"
4,2,2,"db11f898-32f4-ea11-b882-24ee9a37d45c","Robert F. Wagner, Jr. Secondary School for Arts and Technology - Q560 - Q891 - 24Q560 - 47-07 30th Place","d911f898-32f4-ea11-b882-24ee9a37d45c",-73936442,40742217,"R. F. WAGNER SEC SCL ARTS & TECH-Q","47-07 30th Place"
1,0,1,"807e21a6-ebf6-ea11-b883-24ee9a37d459","P.S. Q224 - Q224 - Q266 - 75Q224 - 74-10 COMMONWEALTH BOULEVARD","4aa10a44-32f4-ea11-b882-24ee9a37d45c",-73728415,40746128,"P.S./I.S. 266 - QUEENS","74-10 COMMONWEALTH BOULEVARD"
1,0,1,"898946f4-31f4-ea11-b882-24ee9a37d45c","I.S. 059 Springfield Gardens - Q059 - Q059 - 29Q059 - 132-55 RIDGEDALE STREET","878946f4-31f4-ea11-b882-24ee9a37d45c",-73752772,40681881,"I.S. 59 - QUEENS","132-55 RIDGEDALE STREET"
1,0,1,"6cc4fc0b-4afb-ea11-b883-24ee9a37d459","IMMANUEL CREATIVE - QATX - QATX -  - 163-15 OAK AVENUE","6dc4fc0b-4afb-ea11-b883-24ee9a37d459",-73803794,40750063,"IMMANUEL CREATIVE","163-15 OAK AVENUE"
5,5,0,"daf57030-30f4-ea11-b882-24ee9a37d45c","Magnet School of Math, Science and Design Technology - K010 - K010 - 15K010 - 511 7 AVENUE","dbf57030-30f4-ea11-b882-24ee9a37d45c",-73985946,40660912,"P.S. 10 - BROOKLYN","511 7 AVENUE"
1,0,1,"ea201dab-30f4-ea11-b882-24ee9a37d45c","P.S. 279 Herman Schreiber - K279 - K279 - 18K279 - 1070 EAST 104 STREET","e3201dab-30f4-ea11-b882-24ee9a37d45c",-73892797,40644134,"P.S. 279 - BROOKLYN","1070 EAST 104 STREET"
1,1,0,"18a6ba98-31f4-ea11-b882-24ee9a37d45c","Success Academy Charter School - Union Square - M174 - M460 - 84M174 - 40 IRVING PLACE","16a6ba98-31f4-ea11-b882-24ee9a37d45c",-73987064,40735361,"WASHINGTON IRVING HS - MANHATTAN","40 IRVING PLACE"
1,1,0,"7c34aa92-31f4-ea11-b882-24ee9a37d45c","Landmark High School - M419 - M440 - 02M419 - 351 WEST 18 STREET","7834aa92-31f4-ea11-b882-24ee9a37d45c",-74002540,40743407,"BAYARD RUSTIN EDUCATIONAL COMP-M","351 WEST 18 STREET"
3,2,1,"77c280bd-31f4-ea11-b882-24ee9a37d45c","The Clinton School - M260 - M868 - 02M260 - 10 East 15th Street","78c280bd-31f4-ea11-b882-24ee9a37d45c",-73992727,0,"THE CLINTON SCHOOL - MANHATTAN","10 East 15th Street"
1,1,0,"489d7c62-33f4-ea11-b882-24ee9a37d45c","Astor Collegiate Academy - X299 - X415 - 11X299 - 925 ASTOR AVENUE","439d7c62-33f4-ea11-b882-24ee9a37d45c",-73860729,40860443,"CHRISTOPHER COLUMBUS HS - X","925 ASTOR AVENUE"
1,1,0,"e4f57030-30f4-ea11-b882-24ee9a37d45c","Ronald Edmonds Learning Center II - K484 - K012 - 17K484 - 430 HOWARD AVENUE","def57030-30f4-ea11-b882-24ee9a37d45c",-73920095,40673124,"P.S. 12 - BROOKLYN","430 HOWARD AVENUE"
1,0,1,"202ed53d-33f4-ea11-b882-24ee9a37d45c","P.S. 170 - X170 - X170 - 09X170 - 1598 TOWNSEND AVENUE","212ed53d-33f4-ea11-b882-24ee9a37d45c",-73913253,40844367,"P.S. 170 (ECC) - BRONX","1598 TOWNSEND AVENUE"
5,1,4,"b9b66262-32f4-ea11-b882-24ee9a37d45c","John Bowne High School - Q425 - Q425 - 25Q425 - 63-25 MAIN STREET","bab66262-32f4-ea11-b882-24ee9a37d45c",-73823841,40737448,"JOHN BOWNE HS - QUEENS","63-25 MAIN STREET"
1,1,0,"f4fb3df4-30f4-ea11-b882-24ee9a37d45c","P.S. 160 William T. Sampson - K160 - K521 - 20K160 - 1057 52ND STREET","f5fb3df4-30f4-ea11-b882-24ee9a37d45c",-73999057,0,"P.S. 160 ANNEX - BROOKLYN","1057 52ND STREET"
7,2,5,"c9883319-32f4-ea11-b882-24ee9a37d45c","I.S. 141 The Steinway - Q141 - Q141 - 30Q141 - 37-11 21 AVENUE","ca883319-32f4-ea11-b882-24ee9a37d45c",-73904508,40775766,"I.S. 141 - QUEENS","37-11 21 AVENUE"
1,1,0,"11f32ce2-31f4-ea11-b882-24ee9a37d45c","The 30th Avenue School (G&T Citywide) - Q300 - Q017 - 30Q300 - 28-37 29 STREET","0af32ce2-31f4-ea11-b882-24ee9a37d45c",-73922544,0,"P.S. 17 - QUEENS","28-37 29 STREET"
1,0,1,"72e2635c-32f4-ea11-b882-24ee9a37d45c","District 25 Pre-K Center - Q409 - Q409 - 25Q409 - 14-45 143rd Street","73e2635c-32f4-ea11-b882-24ee9a37d45c",-73826154,0,"DDC UPK CENTER @143RD STREET - QUEENS","14-45 143rd Street"
2,1,1,"61507380-31f4-ea11-b882-24ee9a37d45c","P.S. 189 - M189 - M189 - 06M189 - 2580 AMSTERDAM AVENUE","5f507380-31f4-ea11-b882-24ee9a37d45c",-73928048,40853045,"P.S. 189 - MANHATTAN","2580 AMSTERDAM AVENUE"
2,1,1,"1b78931f-33f4-ea11-b882-24ee9a37d45c","P.S. 121 Throop - X121 - X121 - 11X121 - 2750 THROOP AVENUE","1c78931f-33f4-ea11-b882-24ee9a37d45c",-73850510,40866474,"P.S. 121 - BRONX","2750 THROOP AVENUE"
3,1,2,"8932c3fb-eaf6-ea11-b883-24ee9a37d459","P.S. 018 Park Terrace - M018 - M898 - 06M018 - 4124 9 Avenue","93c280bd-31f4-ea11-b882-24ee9a37d45c",-73911732,40871456,"P.S. 18 - MANHATTAN","4124 9 Avenue"
3,2,1,"29a198c3-30f4-ea11-b882-24ee9a37d45c","P.S. 889 - K889 - K338 - 22K889 - 21 HINCKLEY PLACE","27a198c3-30f4-ea11-b882-24ee9a37d45c",-73971010,40644861,"P.S. 338 - Brooklyn","21 HINCKLEY PLACE"
1,1,0,"0ff32ce2-31f4-ea11-b882-24ee9a37d45c","P.S. 017 Henry David Thoreau - Q017 - Q017 - 30Q017 - 28-37 29 STREET","0af32ce2-31f4-ea11-b882-24ee9a37d45c",-73922544,0,"P.S. 17 - QUEENS","28-37 29 STREET"
3,3,0,"35ebaa73-30f4-ea11-b882-24ee9a37d45c","P.S. 164 Caesar Rodney - K164 - K164 - 20K164 - 4211 14 AVENUE","36ebaa73-30f4-ea11-b882-24ee9a37d45c",-73985739,40637101,"P.S. 164 - BROOKLYN","4211 14 AVENUE"
3,2,1,"74a9d9c3-32f4-ea11-b882-24ee9a37d45c","P.S. 026 The Carteret School - R026 - R026 - 31R026 - 4108 VICTORY BOULEVARD","75a9d9c3-32f4-ea11-b882-24ee9a37d45c",-74190093,40591546,"P.S. 26 - STATEN ISLAND","4108 VICTORY BOULEVARD"
2,0,2,"45ef7338-ebf6-ea11-b883-24ee9a37d459","P.S. K053 - K053 - K437 - 75K053 - 713 CATON AVENUE","4488e6db-30f4-ea11-b882-24ee9a37d45c",-73973363,40647598,"P.S./I.S. 437 - BROOKLYN","713 CATON AVENUE"
6,2,4,"90bc9674-32f4-ea11-b882-24ee9a37d45c","Hillcrest High School - Q505 - Q505 - 28Q505 - 160-05 HIGHLAND AVENUE","8fbc9674-32f4-ea11-b882-24ee9a37d45c",-73803001,0,"HILLCREST HS - Q","160-05 HIGHLAND AVENUE"
3,2,1,"7ea5db98-30f4-ea11-b882-24ee9a37d45c","Brooklyn Science and Engineering Academy - K763 - K244 - 18K763 - 5404 TILDEN AVENUE","7fa5db98-30f4-ea11-b882-24ee9a37d45c",-73925592,40647851,"P.S. 244 - BROOKLYN","5404 TILDEN AVENUE"
1,0,1,"4a0d6d19-33f4-ea11-b882-24ee9a37d45c","P.S. 110 Theodore Schoenfeld - X110 - X110 - 09X110 - 580 CROTONA PARK SOUTH","420d6d19-33f4-ea11-b882-24ee9a37d45c",-73900654,40834470,"P.S. 110 - BRONX","580 CROTONA PARK SOUTH"
6,6,0,"ba689025-33f4-ea11-b882-24ee9a37d45c","J.H.S. 127 The Castle Hill - X127 - X127 - 11X127 - 1560 PURDY STREET","b9689025-33f4-ea11-b882-24ee9a37d45c",-73853203,40838759,"I.S. 127 - BRONX","1560 PURDY STREET"
2,2,0,"752f77fa-31f4-ea11-b882-24ee9a37d45c","P.S. 068 Cambridge - Q068 - Q068 - 24Q068 - 59-09 SAINT FELIX AVENUE","762f77fa-31f4-ea11-b882-24ee9a37d45c",-73897372,40696961,"P.S. 68 - QUEENS","59-09 SAINT FELIX AVENUE"
3,2,1,"86977d2b-32f4-ea11-b882-24ee9a37d45c","P.S. 193 Alfred J. Kennedy - Q193 - Q193 - 25Q193 - 152-20 11 AVENUE","87977d2b-32f4-ea11-b882-24ee9a37d45c",-73808987,40792053,"P.S. 193 - QUEENS","152-20 11 AVENUE"
2,0,2,"24e85c61-30f4-ea11-b882-24ee9a37d45c","M.S. 113 Ronald Edmonds Learning Center - K113 - K113 - 13K113 - 300 ADELPHI STREET","1fe85c61-30f4-ea11-b882-24ee9a37d45c",-73971474,0,"I.S. 113 - BROOKLYN","300 ADELPHI STREET"
3,1,2,"340b210d-33f4-ea11-b882-24ee9a37d45c","Creston Academy - X447 - X079 - 10X447 - 125 EAST 181 STREET","2c0b210d-33f4-ea11-b882-24ee9a37d45c",-73903139,0,"P.S. 79 - BRONX","125 EAST 181 STREET"
2,2,0,"7ed92255-30f4-ea11-b882-24ee9a37d45c","P.S. 90 Edna Cohen School - K090 - K090 - 21K090 - 2840 WEST 12 STREET","7dd92255-30f4-ea11-b882-24ee9a37d45c",-73980387,40578192,"P.S. 90 - BROOKLYN","2840 WEST 12 STREET"
1,1,0,"ab8fd48d-ebf6-ea11-b883-24ee9a37d459","P.S. Q993 - Q993 - Q041 - 75Q993 - 214-43 35 AVENUE","e58442ee-31f4-ea11-b882-24ee9a37d45c",-73771225,40770155,"P.S. 41 - QUEENS","214-43 35 AVENUE"
1,0,1,"8cd92255-30f4-ea11-b882-24ee9a37d45c","P.S. 093 William H. Prescott - K093 - K093 - 13K093 - 31 NEW YORK AVENUE","8ad92255-30f4-ea11-b882-24ee9a37d45c",-73946381,40679079,"P.S. 93 - BROOKLYN","31 NEW YORK AVENUE"
2,1,1,"1e0b210d-33f4-ea11-b882-24ee9a37d45c","The Vida Bogart School for All Children - X352 - X075 - 75X352 - 984 FAILE STREET","1f0b210d-33f4-ea11-b882-24ee9a37d45c",-73888948,40822314,"P.S. 75 - BRONX","984 FAILE STREET"
3,2,1,"778d8486-31f4-ea11-b882-24ee9a37d45c","KIPP Infinity Charter School - M336 - M195 - 84M336 - 625 WEST 133 STREET","758d8486-31f4-ea11-b882-24ee9a37d45c",-73956814,40819793,"TERENCE D. TOLBERT EDUCATION COMPLEX - MANHATTAN","625 WEST 133 STREET"
3,0,3,"693cbf01-ebf6-ea11-b883-24ee9a37d459","P.S. X017 - X017 - X184 - 75X017 - 778 FOREST AVENUE","f88a0044-33f4-ea11-b882-24ee9a37d45c",-73905389,40818703,"I.S. 184 - BRONX","778 FOREST AVENUE"
1,0,1,"51416e00-31f4-ea11-b882-24ee9a37d45c","District 20 Pre-K Center - K768 - K695 - 20K768 - 1258 65th Street","52416e00-31f4-ea11-b882-24ee9a37d45c",-74002487,0,"PRE-K CENTER @ 1258 65TH STREET - BROOKLYN","1258 65th Street"
5,2,3,"39474313-33f4-ea11-b882-24ee9a37d45c","P.S. 095 Sheila Mencher - X095 - X095 - 10X095 - 3961 HILLMAN AVENUE","34474313-33f4-ea11-b882-24ee9a37d45c",-73891664,40883049,"P.S. 95 - BRONX","3961 HILLMAN AVENUE"
2,2,0,"692f77fa-31f4-ea11-b882-24ee9a37d45c","P.S. 063 Old South - Q063 - Q063 - 27Q063 - 90-15 SUTTER AVENUE","6a2f77fa-31f4-ea11-b882-24ee9a37d45c",-73846796,40676978,"P.S. 63 - QUEENS","90-15 SUTTER AVENUE"
5,1,4,"e2b36d80-30f4-ea11-b882-24ee9a37d45c","P.S. 191 Paul Robeson - K191 - K191 - 17K191 - 1600 PARK PLACE","e0b36d80-30f4-ea11-b882-24ee9a37d45c",-73924127,40671730,"P.S. 191 - BROOKLYN","1600 PARK PLACE"
4,4,0,"45e61462-31f4-ea11-b882-24ee9a37d45c","Bard High School Early College - M696 - M097 - 01M696 - 525 EAST HOUSTON STREET","46e61462-31f4-ea11-b882-24ee9a37d45c",-73976093,40718276,"BARD COLLEGE HS (OLD M097) - M","525 EAST HOUSTON STREET"
1,1,0,"a869c231-32f4-ea11-b882-24ee9a37d45c","P.S. 205 Alexander Graham Bell - Q205 - Q205 - 26Q205 - 75-25 BELL BOULEVARD","a769c231-32f4-ea11-b882-24ee9a37d45c",-73756374,40738008,"P.S. 205 - QUEENS","75-25 BELL BOULEVARD"
2,0,2,"cdba3c50-33f4-ea11-b882-24ee9a37d45c","The Highbridge Green School - X361 - X285 - 09X361 - 200 West 167th Street","ceba3c50-33f4-ea11-b882-24ee9a37d45c",-73927892,40838232,"HIGHBRIDGE ENVIRONMENTAL EDUCATION CAMPUS - BRONX","200 West 167th Street"
1,0,1,"01f32ce2-31f4-ea11-b882-24ee9a37d45c","P.S. 012 James B. Colgate - Q012 - Q012 - 24Q012 - 42-00 72 STREET","02f32ce2-31f4-ea11-b882-24ee9a37d45c",-73893466,0,"P.S. 12 - QUEENS","42-00 72 STREET"
3,3,0,"70977d2b-32f4-ea11-b882-24ee9a37d45c","J.H.S. 189 Daniel Carter Beard - Q189 - Q189 - 25Q189 - 144-80 BARCLAY AVENUE","6b977d2b-32f4-ea11-b882-24ee9a37d45c",-73818399,40759963,"J.H.S. 189 - QUEENS","144-80 BARCLAY AVENUE"
1,1,0,"e42ece86-32f4-ea11-b882-24ee9a37d45c","Young Women's Leadership School, Astoria - Q286 - Q739 - 30Q286 - 23-15 Newtown Avenue","e52ece86-32f4-ea11-b882-24ee9a37d45c",-73923830,0,"YOUNG WOMEN'S LEADERSHIP ACADEMY- QUEENS","23-15 Newtown Avenue"
3,1,2,"9ae657bd-30f4-ea11-b882-24ee9a37d45c","P.S. 133 William A. Butler - K133 - K317 - 13K133 - 610 Baltic Street","99e657bd-30f4-ea11-b882-24ee9a37d45c",-73980455,40679916,"P.S. 133 WILLIAM A. BUTLER - BROOKLYN","610 Baltic Street"
1,1,0,"95845cb8-33f4-ea11-b882-24ee9a37d45c","KIPP Infinity Charter School - M336 - XAVN - 84M336 - 201 EAST 144TH STREET","96845cb8-33f4-ea11-b882-24ee9a37d45c",-73926486,40816100,"KIPP High School Building","201 EAST 144TH STREET"
1,0,1,"98a9d9c3-32f4-ea11-b882-24ee9a37d45c","P.S. 39 Francis J. Murphy Jr. - R039 - R039 - 31R039 - 99 Macfarland Avenue","99a9d9c3-32f4-ea11-b882-24ee9a37d45c",-74070610,40597824,"P.S. 39 - STATEN ISLAND","99 Macfarland Avenue"
2,1,1,"7c977d2b-32f4-ea11-b882-24ee9a37d45c","P.S. 191 Mayflower - Q191 - Q191 - 26Q191 - 85-15 258 STREET","7b977d2b-32f4-ea11-b882-24ee9a37d45c",-73708617,40734266,"P.S. 191 - QUEENS","85-15 258 STREET"
1,1,0,"19fc3df4-30f4-ea11-b882-24ee9a37d45c","P.S. 371 - Lillian L. Rashkis - K371 - K564 - 75K371 - 153 35 Street","18fc3df4-30f4-ea11-b882-24ee9a37d45c",-74004342,40655583,"SUNSET PARK HS - BROOKLYN","153 35 Street"
1,0,1,"bf8fd48d-ebf6-ea11-b883-24ee9a37d459","P.S. Q993 - Q993 - Q072 - 75Q993 - 133-25 GUY R BREWER BOULEVARD","852f77fa-31f4-ea11-b882-24ee9a37d45c",-73775643,40675014,"J.H.S. 72 - QUEENS","133-25 GUY R BREWER BOULEVARD"
2,0,2,"6cbc9674-32f4-ea11-b882-24ee9a37d45c","John Adams High School - Q480 - Q480 - 27Q480 - 101-01 ROCKAWAY BOULEVARD","6abc9674-32f4-ea11-b882-24ee9a37d45c",-73838616,40680065,"JOHN ADAMS HS - QUEENS","101-01 ROCKAWAY BOULEVARD"
1,1,0,"9d476368-32f4-ea11-b882-24ee9a37d45c","Queens High School for Language Studies - Q241 - Q460 - 25Q241 - 35-01 UNION STREET","97476368-32f4-ea11-b882-24ee9a37d45c",-73826811,40764892,"FLUSHING HS - Q","35-01 UNION STREET"
1,0,1,"788946f4-31f4-ea11-b882-24ee9a37d45c","P.S. 054 Hillside - Q054 - Q054 - 28Q054 - 86-02 127 STREET","778946f4-31f4-ea11-b882-24ee9a37d45c",-73824629,40702656,"P.S. 54 - QUEENS","86-02 127 STREET"
1,0,1,"4b5365de-ef7b-ed11-b0c6-088e901ef405","Leaders High School - K572 - K401 - 21K572 - 2630 BENSON AVENUE","488dbfcf-30f4-ea11-b882-24ee9a37d45c",-73986313,0,"LAFAYETTE AF - BROOKLYN","2630 BENSON AVENUE"
1,0,1,"b732c3fb-eaf6-ea11-b883-24ee9a37d459","District 27 Pre-K Center - Q336 - Q473 - 27Q336 - 133-40 79TH STREET","2c02926e-32f4-ea11-b882-24ee9a37d45c",-73857176,40671903,"3K CENTER @ 133-40 79TH STREET - QUEENS","133-40 79TH STREET"
1,0,1,"9b83ff9e-30f4-ea11-b882-24ee9a37d45c","Middle School for Art and Philosophy - K588 - K252 - 18K588 - 1084 Lenox Road","9a83ff9e-30f4-ea11-b882-24ee9a37d45c",-73919818,40657712,"I.S. 252 - BROOKLYN","1084 Lenox Road"
3,2,1,"8b11b2e2-32f4-ea11-b882-24ee9a37d45c","Staten Island School of Civic Leadership - R861 - R861 - 31R861 - 280 REGIS DRIVE","8a11b2e2-32f4-ea11-b882-24ee9a37d45c",-74164427,40620310,"ELIZABETH A. CONNELLY CAMPUS - S.I.","280 REGIS DRIVE"
1,0,1,"d7fab455-31f4-ea11-b882-24ee9a37d45c","P.S. 064 Robert Simon - M064 - M064 - 01M064 - 600 EAST 6 STREET","d3fab455-31f4-ea11-b882-24ee9a37d45c",-73981597,40723130,"P.S. 64 (OLD 71) - MANHATTAN","600 EAST 6 STREET"
1,1,0,"1c7eed06-32f4-ea11-b882-24ee9a37d45c","P.S. 090 Horace Mann - Q090 - Q090 - 27Q090 - 86-50 109 STREET","1d7eed06-32f4-ea11-b882-24ee9a37d45c",-73839517,40696653,"P.S. 90 - QUEENS","86-50 109 STREET"
2,0,2,"f511a0be-ebf6-ea11-b883-24ee9a37d459","Mosaic Pre-K Center - Q331 - Q777 - 24Q331 - 50-15 44th Street","f22ece86-32f4-ea11-b882-24ee9a37d45c",-73921346,40736680,"PS 199 ANNEX(@ST. TERESA'S) - QUEENS","50-15 44th Street"
1,1,0,"2baf0313-32f4-ea11-b882-24ee9a37d45c","P.S. 139 Rego Park - Q139 - Q139 - 28Q139 - 93-06 63 DRIVE","29af0313-32f4-ea11-b882-24ee9a37d45c",-73862561,40728012,"P.S. 139 - QUEENS","93-06 63 DRIVE"
2,0,2,"7b53dd74-33f4-ea11-b882-24ee9a37d45c","Gotham Collaborative High School - X452 - X450 - 08X452 - 1980 LAFAYETTE AVENUE","62ffcc6e-33f4-ea11-b882-24ee9a37d45c",-73855930,40821218,"Adlai E. Stevenson Educational Campus","1980 LAFAYETTE AVENUE"
1,1,0,"13b7c337-32f4-ea11-b882-24ee9a37d45c","P.S. Q222 - Fire Fighter Christopher A. Santora School - Q222 - Q222 - 30Q222 - 86-15 37 AVENUE","14b7c337-32f4-ea11-b882-24ee9a37d45c",-73879991,40750442,"P.S. 222 (ECC) - QUEENS","86-15 37 AVENUE"
1,1,0,"0baf0313-32f4-ea11-b882-24ee9a37d45c","P.S. 130 - Q130 - Q130 - 25Q130 - 200-01 42 AVENUE","04af0313-32f4-ea11-b882-24ee9a37d45c",-73784009,40760219,"P.S. 130 - QUEENS","200-01 42 AVENUE"
1,0,1,"53ffcc6e-33f4-ea11-b882-24ee9a37d45c","World View High School - X353 - X440 - 10X353 - 100 WEST MOSHOLU PARKWAY SOUTH","4cffcc6e-33f4-ea11-b882-24ee9a37d45c",-73889011,40879958,"DEWITT CLINTON HS - X","100 WEST MOSHOLU PARKWAY SOUTH"
1,0,1,"38eabc42-30f4-ea11-b882-24ee9a37d45c","The Urban Assembly Unison School - K351 - K056 - 13K351 - 170 GATES AVENUE","39eabc42-30f4-ea11-b882-24ee9a37d45c",-73960536,40684286,"P.S. 56 - BROOKLYN","170 GATES AVENUE"
1,1,0,"add810ab-31f4-ea11-b882-24ee9a37d45c","Business Of Sports School - M393 - M625 - 02M393 - 439 WEST 49TH STREET","a9d810ab-31f4-ea11-b882-24ee9a37d45c",-73990318,40763655,"HS OF GRAPHIC COMMUNICATION ARTS-M","439 WEST 49TH STREET"
1,0,1,"b256635c-33f4-ea11-b882-24ee9a37d45c","Bronx Regional High School - X480 - X401 - 12X480 - 1010 REV. J. A. POLITE AVENUE","8ce03d56-33f4-ea11-b882-24ee9a37d45c",-73898265,40823124,"BRONX REGIONAL HS (OLD 133) - X","1010 REV. J. A. POLITE AVENUE"
3,2,1,"d6454b50-32f4-ea11-b882-24ee9a37d45c","The Children's Lab School - Q343 - Q313 - 24Q343 - 45-45 42ND STREET","d7454b50-32f4-ea11-b882-24ee9a37d45c",-73922604,40742580,"THE WALTER MCCAFFREY CAMPUS - QUEENS","45-45 42ND STREET"
4,0,4,"fbce496e-31f4-ea11-b882-24ee9a37d45c","P.S. 128 Audubon - M128 - M128 - 06M128 - 560 WEST 169 STREET","f9ce496e-31f4-ea11-b882-24ee9a37d45c",-73938701,0,"P.S. 128 - MANHATTAN","560 WEST 169 STREET"
1,1,0,"de9319d7-ebf6-ea11-b883-24ee9a37d459","The Richmond Pre-K Center - R066 - R090 - 31R066 - 1535 RICHMOND AVENUE","f18521d0-32f4-ea11-b882-24ee9a37d45c",-74159152,0,"3K CENTER @ 1535 RICHMOND AVENUE - STATEN ISLAND","1535 RICHMOND AVENUE"
2,2,0,"4b0b210d-33f4-ea11-b882-24ee9a37d45c","P.S. 083 Donald Hertz - X083 - X083 - 11X083 - 950 RHINELANDER AVENUE","4c0b210d-33f4-ea11-b882-24ee9a37d45c",-73858769,40849176,"P.S. 83 - BRONX","950 RHINELANDER AVENUE"
2,2,0,"d4fa079f-32f4-ea11-b882-24ee9a37d45c","P.S. 206 The Horace Harding School - Q206 - Q956 - 28Q206 - 61-21 97 PLACE","d5fa079f-32f4-ea11-b882-24ee9a37d45c",-73861004,40734040,"P.S. 206 TRANSPORTABLE - Q","61-21 97 PLACE"
1,1,0,"44ff3d8d-33f4-ea11-b882-24ee9a37d45c","High School of American Studies at Lehman College - X696 - X905 - 10X696 - 2925 Goulden Avenue","45ff3d8d-33f4-ea11-b882-24ee9a37d45c",-73895543,40874725,"HS OF AMERICAN STUDIES - BRONX","2925 Goulden Avenue"
1,0,1,"64977d2b-32f4-ea11-b882-24ee9a37d45c","J.H.S. 185 Edward Bleeker - Q185 - Q185 - 25Q185 - 147-26 25 DRIVE","ae0e6e25-32f4-ea11-b882-24ee9a37d45c",-73818607,40774906,"J.H.S. 185 - QUEENS","147-26 25 DRIVE"
1,0,1,"a532c3fb-eaf6-ea11-b883-24ee9a37d459","P.S. Q255 - Q255 - Q168 - 75Q255 - 158-40 76 ROAD","099c4c1f-32f4-ea11-b882-24ee9a37d45c",-73809380,40724195,"J.H.S. 168 - QUEENS","158-40 76 ROAD"
2,1,1,"13ba8b86-30f4-ea11-b882-24ee9a37d45c","P.S. 206 Joseph F Lamb - K206 - K206 - 22K206 - 2200 GRAVESEND NECK ROAD","14ba8b86-30f4-ea11-b882-24ee9a37d45c",-73948453,0,"P.S. 206 - BROOKLYN","2200 GRAVESEND NECK ROAD"
25,12,13,"555b4cd6-32f4-ea11-b882-24ee9a37d45c","Port Richmond High School - R445 - R445 - 31R445 - 85 ST JOSEPHS AVENUE","515b4cd6-32f4-ea11-b882-24ee9a37d45c",-74141924,40635562,"PORT RICHMOND HS - S. I.","85 ST JOSEPHS AVENUE"
1,1,0,"580d6d19-33f4-ea11-b882-24ee9a37d45c","Leaders of Tomorrow - X370 - X113 - 11X370 - 3710 BARNES AVENUE","520d6d19-33f4-ea11-b882-24ee9a37d45c",-73860126,40880649,"I.S. 113 - BRONX","3710 BARNES AVENUE"
2,2,0,"f3ed94c3-31f4-ea11-b882-24ee9a37d45c","Paula Hedbavny School - M278 - M918 - 06M278 - 421 W 219th St","f4ed94c3-31f4-ea11-b882-24ee9a37d45c",-73912339,40871673,"P.S./IS 278 - MANHATTAN","421 W 219th St"
2,2,0,"ba17ab87-ebf6-ea11-b883-24ee9a37d459","P.S. Q255 - Q255 - Q007 - 75Q255 - 80-55 CORNISH AVENUE","ecf22ce2-31f4-ea11-b882-24ee9a37d45c",-73882446,40739644,"P.S. 7 - QUEENS","80-55 CORNISH AVENUE"
2,1,1,"a169c231-32f4-ea11-b882-24ee9a37d45c","I.S. 204 Oliver W. Holmes - Q204 - Q204 - 30Q204 - 36-41 28 STREET","9c69c231-32f4-ea11-b882-24ee9a37d45c",-73932628,40756471,"I.S. 204 - QUEENS","36-41 28 STREET"
1,0,1,"d53159fa-30f4-ea11-b882-24ee9a37d45c","George Westinghouse Career and Technical Education High School - K605 - K580 - 13K605 - 105 TECH PLACE","d33159fa-30f4-ea11-b882-24ee9a37d45c",-73986105,40695444,"GEORGE WESTINGHOUSE VOC HS - K","105 TECH PLACE"
2,0,2,"912aa42b-33f4-ea11-b882-24ee9a37d45c","The Angelo Patri Middle School - X391 - X137 - 10X391 - 2225 WEBSTER AVENUE","8e2aa42b-33f4-ea11-b882-24ee9a37d45c",-73897404,40854257,"I.S. 391 (UDC) - BRONX","2225 WEBSTER AVENUE"
2,2,0,"652f77fa-31f4-ea11-b882-24ee9a37d45c","P. S. 62 - Chester Park School - Q062 - Q062 - 27Q062 - 97-25 108 STREET","642f77fa-31f4-ea11-b882-24ee9a37d45c",-73835567,40688359,"P.S. 62 - QUEENS","97-25 108 STREET"
4,1,3,"5e8946f4-31f4-ea11-b882-24ee9a37d45c","P.S. 046 Alley Pond - Q046 - Q046 - 26Q046 - 64-45 218 STREET","5f8946f4-31f4-ea11-b882-24ee9a37d45c",-73758042,40745744,"P.S. 46 - QUEENS","64-45 218 STREET"
1,1,0,"e377bb9f-33f4-ea11-b882-24ee9a37d45c","Urban Assembly School for Applied Math and Science, The - X241 - X970 - 09X241 - 1595 BATHGATE AVENUE","e177bb9f-33f4-ea11-b882-24ee9a37d45c",-73901774,40839508,"BATHGATE HS - BRONX","1595 BATHGATE AVENUE"
2,0,2,"af69c231-32f4-ea11-b882-24ee9a37d45c","P.S. 207 Rockwood Park - Q207 - Q207 - 27Q207 - 159-15 88 STREET","b069c231-32f4-ea11-b882-24ee9a37d45c",-73843881,40657736,"PS/MS 207 Queens","159-15 88 STREET"
1,1,0,"009c4c1f-32f4-ea11-b882-24ee9a37d45c","P.S. 162 John Golden - Q162 - Q162 - 26Q162 - 201-02 53 AVENUE","019c4c1f-32f4-ea11-b882-24ee9a37d45c",-73776576,40748405,"P.S. 162 - QUEENS","201-02 53 AVENUE"
1,1,0,"c392e6d5-30f4-ea11-b882-24ee9a37d45c","Cultural Academy for the Arts and Sciences - K629 - K415 - 18K629 - 5800 TILDEN AVENUE","5b8dbfcf-30f4-ea11-b882-24ee9a37d45c",-73922212,40647728,"SAMUEL J. TILDEN EDUCATIONAL CAMPUS - K","5800 TILDEN AVENUE"
1,0,1,"cc2ff20c-32f4-ea11-b882-24ee9a37d45c","The James J. Ambrose School - Q115 - Q115 - 26Q115 - 80-51 261 STREET","cd2ff20c-32f4-ea11-b882-24ee9a37d45c",-73709404,40744201,"The James J. Ambrose School","80-51 261 STREET"
2,0,2,"18f32ce2-31f4-ea11-b882-24ee9a37d45c","P.S. 019 Marino Jeantet - Q019 - Q019 - 24Q019 - 98-02 ROOSEVELT AVENUE","19f32ce2-31f4-ea11-b882-24ee9a37d45c",-73866557,40748600,"P.S. 19 - QUEENS","98-02 ROOSEVELT AVENUE"
8,3,5,"e83159fa-30f4-ea11-b882-24ee9a37d45c","Clara Barton High School - K600 - K600 - 17K600 - 901 CLASSON AVENUE","e13159fa-30f4-ea11-b882-24ee9a37d45c",-73960689,40669805,"CLARA BARTON HS - K","901 CLASSON AVENUE"
2,0,2,"73a78d44-ebf6-ea11-b883-24ee9a37d459","P.S. K369 - Coy L. Cox School - K369 - K580 - 75K369 - 105 TECH PLACE","d33159fa-30f4-ea11-b882-24ee9a37d45c",-73986105,40695444,"GEORGE WESTINGHOUSE VOC HS - K","105 TECH PLACE"
3,1,2,"e6b98b86-30f4-ea11-b882-24ee9a37d45c","P.S. 193 Gil Hodges - K193 - K193 - 22K193 - 2515 AVENUE L","e5b98b86-30f4-ea11-b882-24ee9a37d45c",-73950321,40622080,"P.S. 193 - BROOKLYN","2515 AVENUE L"
1,0,1,"8436d900-33f4-ea11-b882-24ee9a37d45c","P.S. 062 Inocensio Casanova - X062 - X062 - 08X062 - 660 FOX STREET","8336d900-33f4-ea11-b882-24ee9a37d45c",-73900161,40813736,"P.S. 62 - BRONX","660 FOX STREET"
2,2,0,"be56635c-33f4-ea11-b882-24ee9a37d45c","Bronx River High School - X349 - X405 - 08X349 - 3000 EAST TREMONT AVENUE","b556635c-33f4-ea11-b882-24ee9a37d45c",-73839583,40839775,"HERBERT H. LEHMAN HS - X","3000 EAST TREMONT AVENUE"
3,3,0,"dd4356d0-48fb-ea11-b883-24ee9a37d459","Giocare 23rd Street - KCOT - KCRX -  - 552 5 Avenue","de4356d0-48fb-ea11-b883-24ee9a37d459",-73989669,40665577,"Giocare, LLC - 552 5 Avenue","552 5 Avenue"
3,0,3,"94a9d9c3-32f4-ea11-b882-24ee9a37d45c","P.S. 038 George Cromwell - R038 - R038 - 31R038 - 421 LINCOLN AVENUE","92a9d9c3-32f4-ea11-b882-24ee9a37d45c",-74099409,40574799,"P.S. 38 - STATEN ISLAND","421 LINCOLN AVENUE"
1,0,1,"519587f5-ebf6-ea11-b883-24ee9a37d459","P.S. X017 - X017 - X174 - 75X017 - 456 WHITE PLAINS ROAD","2a2ed53d-33f4-ea11-b882-24ee9a37d45c",-73856070,40815043,"I.S. 174 - BRONX","456 WHITE PLAINS ROAD"
3,1,2,"de21d292-30f4-ea11-b882-24ee9a37d45c","J.H.S. 223 The Montauk - K223 - K223 - 20K223 - 4200 16 AVENUE","735bc58c-30f4-ea11-b882-24ee9a37d45c",-73982424,40635100,"I.S. 223 - BROOKLYN","4200 16 AVENUE"
6,1,5,"0dba8b86-30f4-ea11-b882-24ee9a37d45c","P.S. 204 Vince Lombardi - K204 - K204 - 20K204 - 8101 15 AVENUE","0eba8b86-30f4-ea11-b882-24ee9a37d45c",-74006137,0,"P.S. 204 - BROOKLYN","8101 15 AVENUE"
2,2,0,"5707e99e-31f4-ea11-b882-24ee9a37d45c","Institute for Collaborative Education - M407 - M475 - 02M407 - 345 East 15th Street","5607e99e-31f4-ea11-b882-24ee9a37d45c",-73982590,40732665,"HEALTH PROFESSIONS HS (OL STY) - M","345 East 15th Street"
2,1,1,"c50d3c5b-30f4-ea11-b882-24ee9a37d45c","I.S. 096 Seth Low - K096 - K096 - 21K096 - 99 AVENUE P","c10d3c5b-30f4-ea11-b882-24ee9a37d45c",-73984985,40608135,"I.S. 96 - BROOKLYN","99 AVENUE P"
1,1,0,"858d8486-31f4-ea11-b882-24ee9a37d45c","P.S. 199 Jessie Isador Straus - M199 - M199 - 03M199 - 270 WEST 70 STREET","868d8486-31f4-ea11-b882-24ee9a37d45c",-73984423,40777603,"P.S. 199 - MANHATTAN","270 WEST 70 STREET"
1,1,0,"0618b7f4-32f4-ea11-b882-24ee9a37d45c","P.S./M.S. 029 Melrose School - X029 - X029 - 07X029 - 758 COURTLANDT AVENUE","0718b7f4-32f4-ea11-b882-24ee9a37d45c",-73916419,40821544,"P.S. 29 - BRONX","758 COURTLANDT AVENUE"
2,2,0,"209ebaee-32f4-ea11-b882-24ee9a37d45c","P.S. X015 Institute for Environmental Learning - X015 - X015 - 10X015 - 2195 ANDREWS AVENUE","219ebaee-32f4-ea11-b882-24ee9a37d45c",-73909763,40859243,"P.S. 15 - BRONX","2195 ANDREWS AVENUE"
2,0,2,"882aa42b-33f4-ea11-b882-24ee9a37d45c","P186X Walter J. Damrosch School - X186 - X136 - 75X186 - 750 Jennings Street","892aa42b-33f4-ea11-b882-24ee9a37d45c",-73897797,40831388,"P.S. 186 (OLD J136) - BRONX","750 Jennings Street"
1,0,1,"29a10a44-32f4-ea11-b882-24ee9a37d45c","Learners and Leaders - Q305 - Q245 - 24Q305 - 378 Seneca Avenue","26a10a44-32f4-ea11-b882-24ee9a37d45c",-73914990,40706837,"P.S. 245 ECC - QUEENS","378 Seneca Avenue"
1,0,1,"81a78d44-ebf6-ea11-b883-24ee9a37d459","P.S. K771 - K771 - K721 - 75K771 - 8310 21ST AVENUE","56416e00-31f4-ea11-b882-24ee9a37d45c",-73995084,40604980,"BROOKLYN STUDIO (TANDEM K128) - K","8310 21ST AVENUE"
1,0,1,"7e886843-31f4-ea11-b882-24ee9a37d45c","P.S. 004 Duke Ellington - M004 - M004 - 06M004 - 500 WEST 160 STREET","7f886843-31f4-ea11-b882-24ee9a37d45c",-73941594,40834877,"P.S. 4 - MANHATTAN","500 WEST 160 STREET"
1,0,1,"2768ee1e-31f4-ea11-b882-24ee9a37d45c","P.S. 209 Margaret Mead - K209 - K941 - 21K209 - 2609 EAST 7 STREET","2868ee1e-31f4-ea11-b882-24ee9a37d45c",-73961191,40586800,"P.S. 209 TRANSPORTABLE - K","2609 EAST 7 STREET"
2,0,2,"969c11e8-30f4-ea11-b882-24ee9a37d45c","Park Slope Collegiate - K464 - K460 - 15K464 - 237 7 AVENUE","929c11e8-30f4-ea11-b882-24ee9a37d45c",-73978580,40669255,"John Jay Educational Campus","237 7 AVENUE"
2,2,0,"9b53dd74-33f4-ea11-b882-24ee9a37d45c","Bronx School of Law and Finance - X284 - X475 - 10X284 - 99 TERRACE VIEW AVENUE","9853dd74-33f4-ea11-b882-24ee9a37d45c",-73912686,40877379,"JOHN F. KENNEDY HS - X","99 TERRACE VIEW AVENUE"
2,0,2,"9a2aa42b-33f4-ea11-b882-24ee9a37d45c","International Community High School - X334 - X139 - 07X334 - 345 BROOK AVENUE","942aa42b-33f4-ea11-b882-24ee9a37d45c",-73918774,40810314,"J.H.S. 222 - BRONX","345 BROOK AVENUE"
1,0,1,"b5b36d80-30f4-ea11-b882-24ee9a37d45c","P.S. 179 Kensington - K179 - K179 - 20K179 - 202 AVENUE C","13d1de79-30f4-ea11-b882-24ee9a37d45c",-73977260,40640127,"P.S. 179 - BROOKLYN","202 AVENUE C"
1,0,1,"3e0b210d-33f4-ea11-b882-24ee9a37d45c","I.S. X303 Leadership & Community Service - X303 - X082 - 09X303 - 1700 MACOMBS ROAD","3f0b210d-33f4-ea11-b882-24ee9a37d45c",-73915217,40849416,"I.S. 232 - BRONX","1700 MACOMBS ROAD"
3,3,0,"29e61462-31f4-ea11-b882-24ee9a37d45c","P.S. 89 - M089 - M089 - 02M089 - 201 WARREN STREET","9741e65b-31f4-ea11-b882-24ee9a37d45c",-74013967,40717010,"P.S./I.S. 89 - MANHATTAN","201 WARREN STREET"
1,0,1,"4c042f6f-ebf6-ea11-b883-24ee9a37d459","Adult and Continuing Education - K755 - M510 - 79K755 - 198 Forsyth Street","d737fba4-31f4-ea11-b882-24ee9a37d45c",-73990468,40722415,"FORSYTH HS (AUXSVC-OLD 91) - M","198 Forsyth Street"
1,0,1,"d9968d36-30f4-ea11-b882-24ee9a37d45c","P.S. 020 Clinton Hill - K020 - K020 - 13K020 - 225 ADELPHI STREET","d1968d36-30f4-ea11-b882-24ee9a37d45c",-73970896,40690742,"P.S. 20 - BROOKLYN","225 ADELPHI STREET"
1,0,1,"7fe2635c-32f4-ea11-b882-24ee9a37d45c","ALC - Beach Channel Educational Complex - Q996 - Q410 - 88Q996 - 100-00 BEACH CHANNEL DRIVE","71e2635c-32f4-ea11-b882-24ee9a37d45c",-73825317,40586012,"Beach Channel Educational Campus","100-00 BEACH CHANNEL DRIVE"
1,1,0,"c7e0838c-31f4-ea11-b882-24ee9a37d45c","Battery Park City School - M276 - M276 - 02M276 - 55 BATTERY PLACE","c6e0838c-31f4-ea11-b882-24ee9a37d45c",-74017456,40706384,"P.S./I.S. 276 - MANHATTAN","55 BATTERY PLACE"
5,1,4,"26a198c3-30f4-ea11-b882-24ee9a37d45c","M.S. 890 - K890 - K338 - 22K890 - 21 HINCKLEY PLACE","27a198c3-30f4-ea11-b882-24ee9a37d45c",-73971010,40644861,"P.S. 338 - Brooklyn","21 HINCKLEY PLACE"
1,0,1,"fd8ac007-ebf6-ea11-b883-24ee9a37d459","KIPP Freedom Charter School - X598 - X859 - 84X598 - 2246 JEROME AVENUE","a3593c87-33f4-ea11-b882-24ee9a37d45c",-73903764,40857932,"P.S. 315 - BRONX","2246 JEROME AVENUE"
10,8,2,"9d886843-31f4-ea11-b882-24ee9a37d45c","P.S. 011: The Sarah J. Garnet Elementary School - M011 - M011 - 02M011 - 320 WEST 21 STREET","9e886843-31f4-ea11-b882-24ee9a37d45c",-74000743,40744186,"P.S. 11 - MANHATTAN","320 WEST 21 STREET"
2,1,1,"08af0313-32f4-ea11-b882-24ee9a37d45c","P.S. 129 Patricia Larkin - Q129 - Q129 - 25Q129 - 128-02 7 Avenue","09af0313-32f4-ea11-b882-24ee9a37d45c",-73839505,40789926,"P.S. 129 - QUEENS","128-02 7 Avenue"
1,1,0,"68507380-31f4-ea11-b882-24ee9a37d45c","P.S. 452 - M452 - M191 - 03M452 - 210 WEST 61 STREET","69507380-31f4-ea11-b882-24ee9a37d45c",-73987515,40771603,"P.S. 191 - MANHATTAN","210 WEST 61 STREET"
2,2,0,"52474313-33f4-ea11-b882-24ee9a37d45c","M.S. X101 Edward R. Byrne - X101 - X101 - 08X101 - 2750 LAFAYETTE AVENUE","4e474313-33f4-ea11-b882-24ee9a37d45c",-73829211,40827080,"I.S. 101 - BRONX","2750 LAFAYETTE AVENUE"
3,2,1,"848946f4-31f4-ea11-b882-24ee9a37d45c","P.S. 58 - The School of Heroes - Q058 - Q058 - 24Q058 - 72-24 GRAND AVENUE","808946f4-31f4-ea11-b882-24ee9a37d45c",-73890638,40728517,"P.S. 58 - QUEENS","72-24 GRAND AVENUE"
4,4,0,"f2ae0313-32f4-ea11-b882-24ee9a37d45c","P.S. 122 Mamie Fay - Q122 - Q122 - 30Q122 - 21-21 DITMARS BOULEVARD","cb2ff20c-32f4-ea11-b882-24ee9a37d45c",-73915785,40780507,"P.S. 122 - QUEENS","21-21 DITMARS BOULEVARD"
5,3,2,"57ebaa73-30f4-ea11-b882-24ee9a37d45c","Ralph A. Fabrizio School - K170 - K170 - 20K170 - 619 72ND STREET","58ebaa73-30f4-ea11-b882-24ee9a37d45c",-74018719,40630373,"P.S. 170 - BROOKLYN","619 72ND STREET"
1,1,0,"277eed06-32f4-ea11-b882-24ee9a37d45c","P.S. 094 David D. Porter - Q094 - Q094 - 26Q094 - 41-77 Little Neck Parkway","287eed06-32f4-ea11-b882-24ee9a37d45c",-73738703,40771258,"P.S. 94 - QUEENS","41-77 Little Neck Parkway"
1,1,0,"7aa9d9c3-32f4-ea11-b882-24ee9a37d45c","P.S. 029 Bardwell - R029 - R029 - 31R029 - 1581 VICTORY BOULEVARD","7ba9d9c3-32f4-ea11-b882-24ee9a37d45c",-74116197,0,"P.S. 29 - STATEN ISLAND","1581 VICTORY BOULEVARD"
2,2,0,"8fe657bd-30f4-ea11-b882-24ee9a37d45c","P.S. 503: The School of Discovery - K503 - K314 - 20K503 - 330 59 Street","8ee657bd-30f4-ea11-b882-24ee9a37d45c",-74019299,40641950,"P.S. 314 - BROOKLYN","330 59 Street"
4,4,0,"cf2ff20c-32f4-ea11-b882-24ee9a37d45c","P.S./I.S. 116 William C. Hughley - Q116 - Q116 - 29Q116 - 107-25 WREN PLACE","d02ff20c-32f4-ea11-b882-24ee9a37d45c",-73781839,40700840,"P.S. 116 - QUEENS","107-25 WREN PLACE"
4,3,1,"f9b98b86-30f4-ea11-b882-24ee9a37d45c","P.S. 198 Brooklyn - K198 - K198 - 22K198 - 4105 FARRAGUT ROAD","fab98b86-30f4-ea11-b882-24ee9a37d45c",-73937083,40637601,"P.S. 198 - BROOKLYN","4105 FARRAGUT ROAD"
1,1,0,"dd92e6d5-30f4-ea11-b882-24ee9a37d45c","Spring Creek Community School - K422 - K422 - 19K422 - 1065 Elton Street","da92e6d5-30f4-ea11-b882-24ee9a37d45c",-73874064,40657266,"SPRING CREEK EDUCATIONAL CAMPUS - BROOKLYN","1065 Elton Street"
2,2,0,"6941e65b-31f4-ea11-b882-24ee9a37d45c","M.S. 250 West Side Collaborative Middle School - M250 - M075 - 03M250 - 735 WEST END AVENUE","6a41e65b-31f4-ea11-b882-24ee9a37d45c",-73973996,40795109,"P.S. 75 - MANHATTAN","735 WEST END AVENUE"
2,1,1,"df11f898-32f4-ea11-b882-24ee9a37d45c","P.S. 360 - Q360 - Q892 - 29Q360 - 199-10 112 AVENUE","e011f898-32f4-ea11-b882-24ee9a37d45c",-73756259,40702329,"P.S. 892 - QUEENS","199-10 112 AVENUE"
8,3,5,"377c21b7-32f4-ea11-b882-24ee9a37d45c","P.S. 004 Maurice Wollin - R004 - R004 - 31R004 - 200 NEDRA LANE","337c21b7-32f4-ea11-b882-24ee9a37d45c",-74195281,0,"P.S. 4 - STATEN ISLAND","200 NEDRA LANE"
1,1,0,"d6201dab-30f4-ea11-b882-24ee9a37d45c","Kappa V (Knowledge and Power Preparatory Academy) - K518 - K275 - 23K518 - 985 ROCKAWAY AVENUE","d2201dab-30f4-ea11-b882-24ee9a37d45c",-73906662,40655644,"I.S. 275 - BROOKLYN","985 ROCKAWAY AVENUE"
2,2,0,"5ef4a0ef-eaf6-ea11-b883-24ee9a37d459","P.S. K140 - K140 - K258 - 75K140 - 141 MACON STREET","b183ff9e-30f4-ea11-b882-24ee9a37d45c",-73945600,40681920,"I.S. 258 - BROOKLYN","141 MACON STREET"
1,1,0,"722f77fa-31f4-ea11-b882-24ee9a37d45c","J.H.S. 067 Louis Pasteur - Q067 - Q067 - 26Q067 - 51-60 MARATHON PARKWAY","732f77fa-31f4-ea11-b882-24ee9a37d45c",-73734832,40762241,"J.H.S. 67 - QUEENS","51-60 MARATHON PARKWAY"
10,9,1,"f6ce496e-31f4-ea11-b882-24ee9a37d45c","P.S. 126 Jacob August Riis - M126 - M126 - 02M126 - 80 CATHERINE STREET","f4ce496e-31f4-ea11-b882-24ee9a37d45c",-73997420,40710651,"P.S. 126 - MANHATTAN","80 CATHERINE STREET"
11,9,2,"fdd10307-33f4-ea11-b882-24ee9a37d45c","Leaders In Our Neighborhood Charter School - X345 - X074 - 84X345 - 730 BRYANT AVENUE","f9d10307-33f4-ea11-b882-24ee9a37d45c",-73885284,40815827,"I.S. 201 - BRONX","730 BRYANT AVENUE"
1,1,0,"3beabc42-30f4-ea11-b882-24ee9a37d45c","P.S. 056 Lewis H. Latimer - K056 - K056 - 13K056 - 170 GATES AVENUE","39eabc42-30f4-ea11-b882-24ee9a37d45c",-73960536,40684286,"P.S. 56 - BROOKLYN","170 GATES AVENUE"
4,2,2,"84a9d9c3-32f4-ea11-b882-24ee9a37d45c","P.S. 032 The Gifford School - R032 - R032 - 31R032 - 232 Barlow Avenue","80a9d9c3-32f4-ea11-b882-24ee9a37d45c",-74155400,0,"P.S. 32 - STATEN ISLAND","232 Barlow Avenue"
2,1,1,"a132c3fb-eaf6-ea11-b883-24ee9a37d459","P.S. 085 Judge Charles Vallone - Q085 - Q085 - 30Q085 - 23-70 31 STREET","0a7eed06-32f4-ea11-b882-24ee9a37d45c",-73915039,40773126,"P.S. 85 - QUEENS","23-70 31 STREET"
1,0,1,"f7d27c6d-30f4-ea11-b882-24ee9a37d45c","P.S. 153 Homecrest - K153 - K153 - 21K153 - 1970 HOMECREST AVENUE","f8d27c6d-30f4-ea11-b882-24ee9a37d45c",-73960027,40601179,"P.S. 153 - BROOKLYN","1970 HOMECREST AVENUE"
3,1,2,"89e657bd-30f4-ea11-b882-24ee9a37d45c","The Urban Assembly School for Law and Justice - K483 - K313 - 13K483 - 283 ADAMS STREET","82e657bd-30f4-ea11-b882-24ee9a37d45c",-73988323,40694629,"ADAMS STREET EDUCATIONAL CAMPUS - K","283 ADAMS STREET"
3,0,3,"9eeb0e7b-33f4-ea11-b882-24ee9a37d45c","H.E.R.O. High (Health, Education, and Research Occupations High School) - X259 - X655 - 07X259 - 455 SOUTHERN BLVD","99eb0e7b-33f4-ea11-b882-24ee9a37d45c",-73907528,40810671,"SAMUEL GOMPERS VOC HS - X","455 SOUTHERN BLVD"
2,1,1,"8b476368-32f4-ea11-b882-24ee9a37d45c","Newtown High School - Q455 - Q455 - 24Q455 - 48-01 90 STREET","8c476368-32f4-ea11-b882-24ee9a37d45c",-73874129,40740824,"NEWTOWN HS - Q","48-01 90 STREET"
1,1,0,"6241e65b-31f4-ea11-b882-24ee9a37d45c","Yorkville Community School - M151 - M066 - 02M151 - 421 East 88 Street","6341e65b-31f4-ea11-b882-24ee9a37d45c",-73947287,40777948,"RICHARD R GREEN HS OF TEACHING - M","421 East 88 Street"
5,5,0,"748d8486-31f4-ea11-b882-24ee9a37d45c","New Design Middle School - M514 - M195 - 05M514 - 625 WEST 133 STREET","758d8486-31f4-ea11-b882-24ee9a37d45c",-73956814,40819793,"TERENCE D. TOLBERT EDUCATION COMPLEX - MANHATTAN","625 WEST 133 STREET"
1,1,0,"cfc88e4f-31f4-ea11-b882-24ee9a37d45c","47 The American Sign Language and English Secondary School - M047 - M047 - 02M047 - 223 EAST 23 STREET","d0c88e4f-31f4-ea11-b882-24ee9a37d45c",-73981329,40738374,"J.H.S. 47 (SCH FOR THE DEAF) - M","223 EAST 23 STREET"
4,3,1,"db92e6d5-30f4-ea11-b882-24ee9a37d45c","Academy for Young Writers - K404 - K422 - 19K404 - 1065 Elton Street","da92e6d5-30f4-ea11-b882-24ee9a37d45c",-73874064,40657266,"SPRING CREEK EDUCATIONAL CAMPUS - BROOKLYN","1065 Elton Street"
4,3,1,"96e657bd-30f4-ea11-b882-24ee9a37d45c","P.S. 316 Elijah Stroud - K316 - K316 - 17K316 - 750 CLASSON AVENUE","94e657bd-30f4-ea11-b882-24ee9a37d45c",-73961418,40674685,"P.S. 316 - BROOKLYN","750 CLASSON AVENUE"
1,0,1,"ffb98b86-30f4-ea11-b882-24ee9a37d45c","P.S. 200 Benson School - K200 - K200 - 20K200 - 1940 BENSON AVENUE","00ba8b86-30f4-ea11-b882-24ee9a37d45c",-74001915,40602809,"P.S. 200 - BROOKLYN","1940 BENSON AVENUE"
2,0,2,"1878931f-33f4-ea11-b882-24ee9a37d45c","P.S. 310 Marble Hill - X310 - X122 - 10X310 - 260 W KINGSBRIDGE RD","1978931f-33f4-ea11-b882-24ee9a37d45c",-73905547,40872477,"P.S. 310 - BRONX","260 W KINGSBRIDGE RD"
3,2,1,"2578931f-33f4-ea11-b882-24ee9a37d45c","J.H.S. 123 James M. Kieran - X123 - X123 - 08X123 - 1025 MORRISON AVENUE","2378931f-33f4-ea11-b882-24ee9a37d45c",-73874162,40824989,"I.S. 123 - BRONX","1025 MORRISON AVENUE"
1,1,0,"0dd8cf12-31f4-ea11-b882-24ee9a37d45c","P.S. 295 - K295 - K845 - 15K295 - 330 18 STREET","0bd8cf12-31f4-ea11-b882-24ee9a37d45c",-73988743,40660805,"P.S. 295 - BROOKLYN","330 18 STREET"
1,1,0,"4c507380-31f4-ea11-b882-24ee9a37d45c","Professor Juan Bosch Public School - M178 - M178 - 06M178 - 12-18 ELLWOOD STREET","4d507380-31f4-ea11-b882-24ee9a37d45c",-73928301,40859240,"P.S. 178 - MANHATTAN","12-18 ELLWOOD STREET"
1,1,0,"8407e99e-31f4-ea11-b882-24ee9a37d45c","Manhattan / Hunter Science High School - M541 - M490 - 03M541 - 122 AMSTERDAM AVENUE","7c07e99e-31f4-ea11-b882-24ee9a37d45c",-73985608,40774891,"MARTIN LUTHER KING, JR. HS - M","122 AMSTERDAM AVENUE"
4,4,0,"5de61462-31f4-ea11-b882-24ee9a37d45c","J.H.S. 104 Simon Baruch - M104 - M104 - 02M104 - 330 EAST 21 STREET","5ee61462-31f4-ea11-b882-24ee9a37d45c",-73981034,40735879,"I.S. 104 - MANHATTAN","330 EAST 21 STREET"
2,2,0,"21b4977a-32f4-ea11-b882-24ee9a37d45c","International High School at LaGuardia Community College - Q530 - Q520 - 24Q530 - 45-35 VAN DAM STREET","22b4977a-32f4-ea11-b882-24ee9a37d45c",-73933316,0,"MIDDLE COLLEGE CAMPUS - QUEENS","45-35 VAN DAM STREET"
1,0,1,"dfa2f813-ebf6-ea11-b883-24ee9a37d459","P.S. K369 - Coy L. Cox School - K369 - K067 - 75K369 - 51 SAINT EDWARDS STREET","d179df48-30f4-ea11-b882-24ee9a37d45c",-73977674,40695339,"P.S. 67 - BROOKLYN","51 SAINT EDWARDS STREET"
2,0,2,"c38442ee-31f4-ea11-b882-24ee9a37d45c","The Jermaine L. Green STEM Institute of Queens - Q354 - Q030 - 28Q354 - 126-10 BEDELL STREET","c48442ee-31f4-ea11-b882-24ee9a37d45c",-73774668,0,"P.S. 30 - QUEENS","126-10 BEDELL STREET"
5,3,2,"15a6ba98-31f4-ea11-b882-24ee9a37d45c","Gramercy Arts High School - M374 - M460 - 02M374 - 40 IRVING PLACE","16a6ba98-31f4-ea11-b882-24ee9a37d45c",-73987064,40735361,"WASHINGTON IRVING HS - MANHATTAN","40 IRVING PLACE"
3,3,0,"d5e0838c-31f4-ea11-b882-24ee9a37d45c","Lower Manhattan Community Middle School - M896 - M282 - 02M896 - 26 BROADWAY","d1e0838c-31f4-ea11-b882-24ee9a37d45c",-74013303,40705688,"BROADWAY EDUCATION CAMPUS - M","26 BROADWAY"
5,2,3,"0fc73b4a-32f4-ea11-b882-24ee9a37d45c","P.S. 273 - Q273 - Q273 - 27Q273 - 88-07 102ND STREET","10c73b4a-32f4-ea11-b882-24ee9a37d45c",-73844335,40693613,"P.S. 273 - QUEENS","88-07 102ND STREET"
1,0,1,"4988e6db-30f4-ea11-b882-24ee9a37d45c","The High School for Global Citizenship - K528 - K440 - 17K528 - 883 CLASSON AVENUE","4a88e6db-30f4-ea11-b882-24ee9a37d45c",-73960689,40669805,"PROSPECT HEIGHTS HS - K","883 CLASSON AVENUE"
6,1,5,"8583ff9e-30f4-ea11-b882-24ee9a37d45c","M.S. 246 Walt Whitman - K246 - K246 - 17K246 - 72 VERONICA PLACE","8483ff9e-30f4-ea11-b882-24ee9a37d45c",-73953480,40648352,"I.S. 246 - BROOKLYN","72 VERONICA PLACE"
10,8,2,"fbfb3df4-30f4-ea11-b882-24ee9a37d45c","Edward R. Murrow High School - K525 - K525 - 21K525 - 1600 AVENUE L","fafb3df4-30f4-ea11-b882-24ee9a37d45c",-73959141,0,"EDWARD R. MURROW HS - K","1600 AVENUE L"
1,1,0,"60fdc1bd-32f4-ea11-b882-24ee9a37d45c","P.S. 019 The Curtis School - R019 - R019 - 31R019 - 780 Post Avenue","61fdc1bd-32f4-ea11-b882-24ee9a37d45c",-74126851,0,"P.S. 19 - STATEN ISLAND","780 Post Avenue"
1,1,0,"abd810ab-31f4-ea11-b882-24ee9a37d45c","Stephen T. Mather Building Arts & Craftsmanship High School - M139 - M625 - 02M139 - 439 WEST 49TH STREET","a9d810ab-31f4-ea11-b882-24ee9a37d45c",-73990318,40763655,"HS OF GRAPHIC COMMUNICATION ARTS-M","439 WEST 49TH STREET"
1,1,0,"63ffcc6e-33f4-ea11-b882-24ee9a37d45c","The Bronx High School of Science - X445 - X445 - 10X445 - 75 WEST 205 STREET","64ffcc6e-33f4-ea11-b882-24ee9a37d45c",-73889011,40879958,"BRONX HS OF SCIENCE - X","75 WEST 205 STREET"
2,0,2,"07ca024b-84ef-eb11-b8b1-24ee9a37d45c","P.S. Q177 - Q177 - Q435 - 75Q177 - 230-17 HILLSIDE AVENUE","c4b66262-32f4-ea11-b882-24ee9a37d45c",-73739726,0,"MARTIN VAN BUREN HS - QUEENS","230-17 HILLSIDE AVENUE"
4,2,2,"2e0410ca-32f4-ea11-b882-24ee9a37d45c","I.S. 051 Edwin Markham - R051 - R051 - 31R051 - 80 WILLOWBROOK ROAD","2f0410ca-32f4-ea11-b882-24ee9a37d45c",-74145522,40623077,"I.S. 51 - STATEN ISLAND","80 WILLOWBROOK ROAD"
3,3,0,"e08a0044-33f4-ea11-b882-24ee9a37d45c","Bedford Park Elementary School - X077 - X177 - 10X077 - 3177 WEBSTER AVENUE","dc8a0044-33f4-ea11-b882-24ee9a37d45c",-73875375,40872559,"THE NORWOOD EAST CAMPUS - BRONX","3177 WEBSTER AVENUE"
1,1,0,"c3bfa431-33f4-ea11-b882-24ee9a37d45c","P.S. 150 Charles James Fox - X150 - X150 - 12X150 - 920 EAST 167 STREET","c4bfa431-33f4-ea11-b882-24ee9a37d45c",-73894349,40824710,"P.S. 150 - BRONX","920 EAST 167 STREET"
1,0,1,"2ca31781-33f4-ea11-b882-24ee9a37d45c","P.S. 207 - X207 - X819 - 10X207 - 3030 GODWIN TERRACE","2ba31781-33f4-ea11-b882-24ee9a37d45c",-73906197,40878327,"P.S. 207 - BRONX","3030 GODWIN TERRACE"
9,0,9,"f83159fa-30f4-ea11-b882-24ee9a37d45c","Transit Tech Career and Technical Education High School - K615 - K615 - 19K615 - 1 WELLS STREET","f93159fa-30f4-ea11-b882-24ee9a37d45c",-73875328,40678780,"E NY VOC HS OF TRANSIT TECH.-K","1 WELLS STREET"
4,4,0,"5588e6db-30f4-ea11-b882-24ee9a37d45c","New Utrecht High School - K445 - K445 - 20K445 - 1601 80 STREET","5488e6db-30f4-ea11-b882-24ee9a37d45c",-74002308,40613041,"NEW UTRECHT HS - K","1601 80 STREET"
2,2,0,"2ee61462-31f4-ea11-b882-24ee9a37d45c","KIPP NYC Washington Heights Academy Charter School - M068 - M090 - 84M068 - 21 JUMEL PLACE","2ce61462-31f4-ea11-b882-24ee9a37d45c",-73935815,40839139,"I.S. 90 - MANHATTAN","21 JUMEL PLACE"
1,1,0,"46de5eb7-30f4-ea11-b882-24ee9a37d45c","Vista Academy - K661 - K302 - 19K661 - 350 LINWOOD STREET","42de5eb7-30f4-ea11-b882-24ee9a37d45c",-73884211,40677112,"I.S. 302 - BROOKLYN","350 LINWOOD STREET"
1,0,1,"2b7becf3-49fb-ea11-b883-24ee9a37d459","GUILD PRESCHOOL - KBAI - KBAI -  - 1273 57TH STREET","2c7becf3-49fb-ea11-b883-24ee9a37d459",-73996847,40630871,"GUILD FOR EXCEPTIONAL CHILDREN","1273 57TH STREET"
1,0,1,"a2eb0e7b-33f4-ea11-b882-24ee9a37d45c","Crotona International High School - X524 - X660 - 10X524 - 2474 CROTONA AVENUE","a3eb0e7b-33f4-ea11-b882-24ee9a37d45c",-73882487,40855392,"GRACE H. DODGE VOC HS - X","2474 CROTONA AVENUE"
8,1,7,"399f4974-31f4-ea11-b882-24ee9a37d45c","P.S. 140 Nathan Straus - M140 - M140 - 01M140 - 123 RIDGE STREET","3a9f4974-31f4-ea11-b882-24ee9a37d45c",-73983769,40719148,"P.S. 140 - MANHATTAN","123 RIDGE STREET"
1,0,1,"8803194f-30f4-ea11-b882-24ee9a37d45c","Brooklyn Environmental Exploration School (BEES) - K664 - K073 - 23K664 - 251 MAC DOUGAL STREET","8503194f-30f4-ea11-b882-24ee9a37d45c",-73910719,40680679,"P.S. 73 - BROOKLYN","251 MAC DOUGAL STREET"
6,5,1,"f0f22ce2-31f4-ea11-b882-24ee9a37d45c","York Early College Academy - Q284 - Q008 - 28Q284 - 108-35 167 STREET","f1f22ce2-31f4-ea11-b882-24ee9a37d45c",-73786403,0,"J.H.S. 8 - QUEENS","108-35 167 STREET"
1,1,0,"c9315367-30f4-ea11-b882-24ee9a37d45c","Northside Charter High School - K693 - K126 - 84K693 - 424 LEONARD STREET","c3315367-30f4-ea11-b882-24ee9a37d45c",-73947932,40719818,"J.H.S. 126 - BROOKLYN","424 LEONARD STREET"
1,0,1,"4e88e6db-30f4-ea11-b882-24ee9a37d45c","Brooklyn Academy of Science and the Environment - K547 - K440 - 17K547 - 883 CLASSON AVENUE","4a88e6db-30f4-ea11-b882-24ee9a37d45c",-73960689,40669805,"PROSPECT HEIGHTS HS - K","883 CLASSON AVENUE"
1,0,1,"76886843-31f4-ea11-b882-24ee9a37d45c","P.S. 002 Meyer London - M002 - M002 - 02M002 - 122 Henry Street","77886843-31f4-ea11-b882-24ee9a37d45c",-73991523,40712907,"P.S. 2 - MANHATTAN","122 Henry Street"
1,0,1,"822f77fa-31f4-ea11-b882-24ee9a37d45c","P.S. 071 Forest - Q071 - Q071 - 24Q071 - 62-85 FOREST AVENUE","802f77fa-31f4-ea11-b882-24ee9a37d45c",-73904798,40711388,"P.S. 71 - QUEENS","62-85 FOREST AVENUE"
2,0,2,"15fc3df4-30f4-ea11-b882-24ee9a37d45c","District 20 Pre-K Center - K768 - K560 - 20K768 - 550 59 Street","16fc3df4-30f4-ea11-b882-24ee9a37d45c",-74014450,40639394,"PRE-K CENTER @ 550 59 STREET - BROOKLYN","550 59 Street"
1,1,0,"9072c880-32f4-ea11-b882-24ee9a37d45c","Eagle Academy for Young Men III - Q327 - Q633 - 29Q327 - 171-10 Linden Boulevard","9172c880-32f4-ea11-b882-24ee9a37d45c",-73778924,0,"EAGLE ACADEMY - QUEENS","171-10 Linden Boulevard"
1,1,0,"5d9f4974-31f4-ea11-b882-24ee9a37d45c","P.S. 153 Adam Clayton Powell - M153 - M153 - 06M153 - 1750 AMSTERDAM AVENUE","589f4974-31f4-ea11-b882-24ee9a37d45c",-73947599,40826514,"P.S. 153 - MANHATTAN","1750 AMSTERDAM AVENUE"
1,1,0,"9669c231-32f4-ea11-b882-24ee9a37d45c","P.S. 201 The Discovery School for Inquiry and Research - Q201 - Q201 - 25Q201 - 65-11 155 STREET","9769c231-32f4-ea11-b882-24ee9a37d45c",-73813011,40736541,"P.S. 201 - QUEENS","65-11 155 STREET"
2,1,1,"f78052e9-ebf6-ea11-b883-24ee9a37d459","KIPP Freedom Charter School - X598 - X044 - 84X598 - 1825 PROSPECT AVENUE","1d03cefa-32f4-ea11-b882-24ee9a37d45c",-73891086,40842564,"P.S. 44 - BRONX","1825 PROSPECT AVENUE"
6,0,6,"f68052e9-ebf6-ea11-b883-24ee9a37d459","P.S. X017 - X017 - X043 - 75X017 - 165 BROWN PLACE","1803cefa-32f4-ea11-b882-24ee9a37d45c",-73921593,40806452,"P.S. 43 - BRONX","165 BROWN PLACE"
1,1,0,"4c2f7d06-31f4-ea11-b882-24ee9a37d45c","District 20 Pre-K Center - K768 - K762 - 20K768 - 1355 84th Street","4d2f7d06-31f4-ea11-b882-24ee9a37d45c",-74011426,40614474,"PRE-K CENTER @1355 84TH STREET - BROOKLYN","1355 84th Street"
2,0,2,"c148b1f5-eaf6-ea11-b883-24ee9a37d459","Restart Academy - M973 - M834 - 79M973 - 444 WEST 56 STREET","5d6e70b7-31f4-ea11-b882-24ee9a37d45c",-73988610,40767848,"HS FOR ENVIRONMENTAL STUDIES - M","444 WEST 56 STREET"
3,0,3,"f3f22ce2-31f4-ea11-b882-24ee9a37d45c","J.H.S. 008 Richard S. Grossley - Q008 - Q008 - 28Q008 - 108-35 167 STREET","f1f22ce2-31f4-ea11-b882-24ee9a37d45c",-73786403,0,"J.H.S. 8 - QUEENS","108-35 167 STREET"
1,0,1,"07e2abc9-30f4-ea11-b882-24ee9a37d45c","The Science And Medicine Middle School - K366 - K366 - 18K366 - 965 EAST 107TH STREET","08e2abc9-30f4-ea11-b882-24ee9a37d45c",-73891743,40647396,"SHIRLEY CHISHOLM CAMPUS - K","965 EAST 107TH STREET"
1,0,1,"e221d292-30f4-ea11-b882-24ee9a37d45c","P.S. 224 Hale A. Woodruff - K224 - K224 - 19K224 - 757 WORTMAN AVENUE","e121d292-30f4-ea11-b882-24ee9a37d45c",-73866542,0,"P.S. 224 - BROOKLYN","757 WORTMAN AVENUE"
1,1,0,"45767649-31f4-ea11-b882-24ee9a37d45c","M.S. 255 Salk School of Science - M255 - M040 - 02M255 - 320 EAST 20TH STREET","46767649-31f4-ea11-b882-24ee9a37d45c",-73981536,40735328,"P.S. 40 - MANHATTAN","320 EAST 20TH STREET"
2,2,0,"26025a42-4afb-ea11-b883-24ee9a37d459","CHILDREN'S BIG APPLE, INC. - QASW - QASW -  - 37-03 94TH STREET","27025a42-4afb-ea11-b883-24ee9a37d459",-73872822,40750698,"CHILDREN'S BIG APPLE, INC.","37-03 94TH STREET"
1,1,0,"14e85c61-30f4-ea11-b882-24ee9a37d45c","P.S. 110 The Monitor - K110 - K110 - 14K110 - 124 MONITOR STREET","e50d3c5b-30f4-ea11-b882-24ee9a37d45c",-73941926,40723743,"P.S. 110 - BROOKLYN","124 MONITOR STREET"
2,0,2,"d2883319-32f4-ea11-b882-24ee9a37d45c","Queens Transition Center - Q752 - Q142 - 75Q752 - 142-10 LINDEN BOULEVARD","2eaf0313-32f4-ea11-b882-24ee9a37d45c",-73800875,40683473,"P.S. 752 (OLD J142) - QUEENS","142-10 LINDEN BOULEVARD"
2,1,1,"bb48b1f5-eaf6-ea11-b883-24ee9a37d459","School for Cooperative Technical Education - M645 - M646 - 79M645 - 321 East 96 Street","5e0c1bb1-31f4-ea11-b882-24ee9a37d45c",-73945647,40784112,"SCL COOP TECH ED (MNH VOC HS) - M","321 East 96 Street"
2,0,2,"172ed53d-33f4-ea11-b882-24ee9a37d45c","P.S. 214 - X214 - X167 - 12X214 - 1970 WEST FARMS ROAD","152ed53d-33f4-ea11-b882-24ee9a37d45c",-73879931,40839297,"P.S. 214 - BRONX","1970 WEST FARMS ROAD"
1,1,0,"3aa10a44-32f4-ea11-b882-24ee9a37d45c","P.S. 254 - The Rosa Parks School - Q254 - Q254 - 27Q254 - 84-40 101 STREET","39a10a44-32f4-ea11-b882-24ee9a37d45c",-73847886,40697200,"P.S. 254 - QUEENS","84-40 101 STREET"
3,0,3,"5ee2635c-32f4-ea11-b882-24ee9a37d45c","Queens Transition Center - Q752 - Q400 - 75Q752 - 156-10 BAISLEY BOULEVARD","a9eb6056-32f4-ea11-b882-24ee9a37d45c",-73782684,40673949,"AUGUST MARTIN HS - QUEENS","156-10 BAISLEY BOULEVARD"
1,1,0,"9683ff9e-30f4-ea11-b882-24ee9a37d45c","P.S. 251 Paerdegat - K251 - K251 - 22K251 - 1037 EAST 54 STREET","8c83ff9e-30f4-ea11-b882-24ee9a37d45c",-73923894,40631950,"P.S. 251 - BROOKLYN","1037 EAST 54 STREET"
2,0,2,"3d3cbf01-ebf6-ea11-b883-24ee9a37d459","John F. Kennedy Jr. School - Q721 - Q722 - 75Q721 - 57-12 94 STREET","b172c880-32f4-ea11-b882-24ee9a37d45c",-73867882,40735613,"JOHN F. KENNEDY JR. SCHOOL - QUEENS","57-12 94 STREET"
3,3,0,"e59b4c1f-32f4-ea11-b882-24ee9a37d45c","Queens United Middle School - Q289 - Q156 - 29Q289 - 229-02 137 AVENUE","e69b4c1f-32f4-ea11-b882-24ee9a37d45c",-73743327,0,"P.S. 156 - QUEENS","229-02 137 AVENUE"
1,1,0,"9628a20c-31f4-ea11-b882-24ee9a37d45c","Urban Assembly School of Music and Art - K350 - K805 - 13K350 - 49 FLATBUSH AVENUE EXTENSION","9428a20c-31f4-ea11-b882-24ee9a37d45c",-73984528,40697330,"WATER'S EDGE EDUCATIONAL CAMPUS - K","49 FLATBUSH AVENUE EXTENSION"
1,0,1,"aa83ff9e-30f4-ea11-b882-24ee9a37d45c","P.S. 256 Benjamin Banneker - K256 - K256 - 13K256 - 114 KOSCIUSZKO STREET","9f83ff9e-30f4-ea11-b882-24ee9a37d45c",-73949610,40690595,"P.S. 256 - BROOKLYN","114 KOSCIUSZKO STREET"
2,2,0,"2c06003e-32f4-ea11-b882-24ee9a37d45c","P.S. 242 Leonard P. Stavisky Early Childhood School - Q242 - Q242 - 25Q242 - 29-66 137 STREET","2d06003e-32f4-ea11-b882-24ee9a37d45c",-73832005,40769752,"P.S. 242 - (ECC) - QUEENS","29-66 137 STREET"
4,4,0,"f6d0de79-30f4-ea11-b882-24ee9a37d45c","I.S. 171 Abraham Lincoln - K171 - K171 - 19K171 - 528 RIDGEWOOD AVENUE","53ebaa73-30f4-ea11-b882-24ee9a37d45c",-73869434,40685852,"I.S. 171 - BROOKLYN","528 RIDGEWOOD AVENUE"
5,3,2,"c0fc24e8-31f4-ea11-b882-24ee9a37d45c","I.S. 025 Adrien Block - Q025 - Q025 - 25Q025 - 34-65 192 STREET","befc24e8-31f4-ea11-b882-24ee9a37d45c",-73789365,0,"J.H.S. 25 - QUEENS","34-65 192 STREET"
2,2,0,"b272c880-32f4-ea11-b882-24ee9a37d45c","Robert F. Kennedy Community High School - Q670 - Q707 - 25Q670 - 75-40 PARSONS BOULEVARD","b372c880-32f4-ea11-b882-24ee9a37d45c",-73811408,40725280,"R. F. KENNEDY COMM. MIDDLE/HS-Q","75-40 PARSONS BOULEVARD"
1,1,0,"502f7d06-31f4-ea11-b882-24ee9a37d45c","The Maurice Sendak Community School - K118 - K763 - 15K118 - 211 8TH STREET","512f7d06-31f4-ea11-b882-24ee9a37d45c",-73987602,40671145,"P.S. 118 MAURICE SENDAK COMMUNITY SCHOOL- BROOKLYN","211 8TH STREET"
1,0,1,"2d6e3d68-31f4-ea11-b882-24ee9a37d45c","P.S. 38 Roberto Clemente - M038 - M121 - 04M038 - 232 EAST 103 STREET","2b6e3d68-31f4-ea11-b882-24ee9a37d45c",-73944762,40788668,"P.S. 38 (OLD M121) - MANHATTAN","232 EAST 103 STREET"
3,0,3,"440b210d-33f4-ea11-b882-24ee9a37d45c","I.S. 232 - X232 - X082 - 09X232 - 1700 MACOMBS ROAD","3f0b210d-33f4-ea11-b882-24ee9a37d45c",-73915217,40849416,"I.S. 232 - BRONX","1700 MACOMBS ROAD"
9,9,0,"ffbdf08c-32f4-ea11-b882-24ee9a37d45c","Baccalaureate School for Global Education - Q580 - Q798 - 30Q580 - 34-12 36 AVENUE","00bef08c-32f4-ea11-b882-24ee9a37d45c",-73926977,40754975,"BACCALAUREATE SCL FOR GLOBAL ED-Q","34-12 36 AVENUE"
1,1,0,"d78a0044-33f4-ea11-b882-24ee9a37d45c","Archimedes Academy for Math, Science and Technology Applications - X367 - X174 - 08X367 - 456 WHITE PLAINS ROAD","2a2ed53d-33f4-ea11-b882-24ee9a37d45c",-73856070,40815043,"I.S. 174 - BRONX","456 WHITE PLAINS ROAD"
4,3,1,"02ba8b86-30f4-ea11-b882-24ee9a37d45c","The Madeleine Brennan School - K201 - K201 - 20K201 - 8010 12 AVENUE","03ba8b86-30f4-ea11-b882-24ee9a37d45c",-74013749,40619043,"I.S. 201 - BROOKLYN","8010 12 AVENUE"
1,0,1,"1604d718-31f4-ea11-b882-24ee9a37d45c","P.S. 189 The Bilingual Center - K189 - K889 - 17K189 - 1100 EAST NEW YORK AVENUE","1704d718-31f4-ea11-b882-24ee9a37d45c",-73925435,40665228,"P.S. 189 MINISCHOOL - BROOKLYN","1100 EAST NEW YORK AVENUE"
1,0,1,"cb968d36-30f4-ea11-b882-24ee9a37d45c","Conselyea Preparatory School - K577 - K017 - 14K577 - 208 NORTH 5 STREET","cc968d36-30f4-ea11-b882-24ee9a37d45c",-73957300,0,"P.S. 17 - BROOKLYN","208 NORTH 5 STREET"
4,3,1,"fa201dab-30f4-ea11-b882-24ee9a37d45c","P.S. 282 Park Slope - K282 - K282 - 13K282 - 180 6 Avenue","f8201dab-30f4-ea11-b882-24ee9a37d45c",-73977983,40676649,"P.S. 282 - BROOKLYN","180 6 Avenue"
4,4,0,"d8b36d80-30f4-ea11-b882-24ee9a37d45c","P.S. 189 The Bilingual Center - K189 - K189 - 17K189 - 1100 EAST NEW YORK AVENUE","d7b36d80-30f4-ea11-b882-24ee9a37d45c",-73925435,40665228,"P.S. 189 - BROOKLYN","1100 EAST NEW YORK AVENUE"
1,0,1,"c056635c-33f4-ea11-b882-24ee9a37d45c","Herbert H. Lehman High School - X405 - X405 - 08X405 - 3000 EAST TREMONT AVENUE","b556635c-33f4-ea11-b882-24ee9a37d45c",-73839583,40839775,"HERBERT H. LEHMAN HS - X","3000 EAST TREMONT AVENUE"
3,2,1,"24e2abc9-30f4-ea11-b882-24ee9a37d45c","KIPP Always Mentally Prepared Charter School - K357 - K390 - 84K357 - 1224 PARK PLACE","25e2abc9-30f4-ea11-b882-24ee9a37d45c",-73937601,40672290,"I.S. 390 - BROOKLYN","1224 PARK PLACE"
1,1,0,"e39b4c1f-32f4-ea11-b882-24ee9a37d45c","P.S. 154 Queens - Q154 - Q154 - 25Q154 - 75-02 162 Street","d69b4c1f-32f4-ea11-b882-24ee9a37d45c",-73807750,40726473,"P.S. 154 - QUEENS","75-02 162 Street"
3,0,3,"5c042f6f-ebf6-ea11-b883-24ee9a37d459","Home Instruction - M501 - M641 - 75M501 - 250 West Houston Street","4d0c1bb1-31f4-ea11-b882-24ee9a37d45c",-74006155,0,"CITY-AS-SCHOOL(OLD 95) - MANHATTAN","250 West Houston Street"
1,1,0,"612f77fa-31f4-ea11-b882-24ee9a37d45c","I.S. 061 Leonardo Da Vinci - Q061 - Q061 - 24Q061 - 98-50 50 AVENUE","5f2f77fa-31f4-ea11-b882-24ee9a37d45c",-73862886,40741898,"I.S. 61 - QUEENS","98-50 50 AVENUE"
4,1,3,"38c73b4a-32f4-ea11-b882-24ee9a37d45c","Corona Arts & Sciences Academy - Q311 - Q311 - 24Q311 - 98-11 44TH AVENUE","36c73b4a-32f4-ea11-b882-24ee9a37d45c",-73865239,0,"P.S./ I.S. 311 - QUEENS","98-11 44TH AVENUE"
2,0,2,"0b8bc007-ebf6-ea11-b883-24ee9a37d459","Home Instruction - Bronx - X999 - X953 - 75X502 - 3450 EAST TREMONT AVENUE","fa27b299-33f4-ea11-b882-24ee9a37d45c",-73827642,40831829,"AUXILIARY SERVICES HS - BRONX","3450 EAST TREMONT AVENUE"
1,1,0,"ff02cefa-32f4-ea11-b882-24ee9a37d45c","P.S. 036 Unionport - X036 - X036 - 08X036 - 1070 Castle Hill Avenue","0c18b7f4-32f4-ea11-b882-24ee9a37d45c",-73849791,40829480,"P.S. 36 - BRONX","1070 Castle Hill Avenue"
3,3,0,"d4f57030-30f4-ea11-b882-24ee9a37d45c","The Emily Warren Roebling School - K008 - K008 - 13K008 - 37 HICKS STREET","d5f57030-30f4-ea11-b882-24ee9a37d45c",-73992841,40700709,"P.S. 8 - BROOKLYN","37 HICKS STREET"
3,2,1,"19e85c61-30f4-ea11-b882-24ee9a37d45c","I.S. 347 School of Humanities - K347 - K111 - 32K347 - 35 STARR STREET","18e85c61-30f4-ea11-b882-24ee9a37d45c",-73927938,40700810,"I.S. 111 - BROOKLYN","35 STARR STREET"
1,1,0,"55a5db98-30f4-ea11-b882-24ee9a37d45c","J.H.S. 234 Arthur W. Cunningham - K234 - K234 - 22K234 - 1875 EAST 17 STREET","56a5db98-30f4-ea11-b882-24ee9a37d45c",-73955217,40604447,"I.S. 234 - BROOKLYN","1875 EAST 17 STREET"
20,16,4,"32416e00-31f4-ea11-b882-24ee9a37d45c","The Math & Science Exploratory School - K447 - K655 - 15K447 - 345 DEAN STREET","30416e00-31f4-ea11-b882-24ee9a37d45c",-73980266,40683951,"BKLYN HS OF THE ARTS (OL S J HL)-K","345 DEAN STREET"
1,1,0,"a2886843-31f4-ea11-b882-24ee9a37d45c","Central Park East High School - M555 - M013 - 04M555 - 1573 MADISON AVENUE","98886843-31f4-ea11-b882-24ee9a37d45c",-73948488,40793649,"I.S. 13 - MANHATTAN","1573 MADISON AVENUE"
1,0,1,"192ed53d-33f4-ea11-b882-24ee9a37d45c","Emolior Academy - X383 - X167 - 12X383 - 1970 WEST FARMS ROAD","152ed53d-33f4-ea11-b882-24ee9a37d45c",-73879931,40839297,"P.S. 214 - BRONX","1970 WEST FARMS ROAD"
5,3,2,"8dd810ab-31f4-ea11-b882-24ee9a37d45c","Manhattan Bridges High School - M542 - M535 - 02M542 - 525 WEST 50TH STREET","f137fba4-31f4-ea11-b882-24ee9a37d45c",-73992700,40765474,"PARK WEST HS (ECF) - MANHATTAN","525 WEST 50TH STREET"
1,0,1,"1c7becf3-49fb-ea11-b883-24ee9a37d459","Cassidy's Place - MABK - MABK -  - 419 EAST 86 STREET","1d7becf3-49fb-ea11-b883-24ee9a37d459",-73948393,40776766,"CASSIDY'S PLACE","419 EAST 86 STREET"
6,6,0,"30b4977a-32f4-ea11-b882-24ee9a37d45c","Frank Sinatra School of the Arts High School - Q501 - Q570 - 30Q501 - 35-12 35TH AVENUE","2eb4977a-32f4-ea11-b882-24ee9a37d45c",-73925182,0,"FRANK SINATRA HIGH SCHOOL-Q","35-12 35TH AVENUE"
2,1,1,"14025a42-4afb-ea11-b883-24ee9a37d459","Childcare Partners NY West - MBHM - MBHM -  - 28 WASHINGTON STREET","15025a42-4afb-ea11-b883-24ee9a37d459",-74015273,40705949,"Childcare Partners NY West","28 WASHINGTON STREET"
1,0,1,"204f5ffd-e11e-eb11-b885-24ee9a37d45c","District 29 Pre-K Center - Q381 - Q363 - 29Q381 - 134-35 Springfield Boulevard","214f5ffd-e11e-eb11-b885-24ee9a37d45c",-73753270,0,"3K CENTER @ SPRINGFIELD BOULEVARD - QUEENS","134-35 Springfield Boulevard"
1,0,1,"4ab225fb-6c0c-ed11-b091-088e901ef405","P186X Walter J. Damrosch School - X186 - X050 - 75X186 - 1550 VYSE AVENUE","5836d900-33f4-ea11-b882-24ee9a37d45c",-73886995,40834188,"P.S. 50 - BRONX","1550 VYSE AVENUE"
3,3,0,"95977d2b-32f4-ea11-b882-24ee9a37d45c","Goldie Maple Academy - Q333 - Q198 - 27Q333 - 3-65 BEACH 56 STREET","85977d2b-32f4-ea11-b882-24ee9a37d45c",-73786649,0,"I.S. 198 - QUEENS","3-65 BEACH 56 STREET"
1,0,1,"84977d2b-32f4-ea11-b882-24ee9a37d45c","P.S. Q256 - Q256 - Q198 - 75Q256 - 3-65 BEACH 56 STREET","85977d2b-32f4-ea11-b882-24ee9a37d45c",-73786649,0,"I.S. 198 - QUEENS","3-65 BEACH 56 STREET"
1,0,1,"0f497593-33f4-ea11-b882-24ee9a37d45c","P.S. 076 The Bennington School - X076 - X926 - 11X076 - 900 ADEE AVENUE","10497593-33f4-ea11-b882-24ee9a37d45c",-73860928,40869059,"P.S. 76 TEMP. C.R. BLDG. - X","900 ADEE AVENUE"
3,3,0,"df2ece86-32f4-ea11-b882-24ee9a37d45c","Bard High School Early College Queens - Q299 - Q735 - 24Q299 - 30-20 THOMSON AVENUE","db2ece86-32f4-ea11-b882-24ee9a37d45c",-73937004,0,"QUEENS HIGH SCHOOL COMPLEX - Q","30-20 THOMSON AVENUE"
1,0,1,"240b210d-33f4-ea11-b882-24ee9a37d45c","P.S. 076 The Bennington School - X076 - X076 - 11X076 - 900 ADEE AVENUE","250b210d-33f4-ea11-b882-24ee9a37d45c",-73860928,40869059,"P.S. 76 - BRONX","900 ADEE AVENUE"
2,0,2,"37a10a44-32f4-ea11-b882-24ee9a37d45c","P.S. Q256 - Q256 - Q253 - 75Q256 - 1307 CENTRAL AVENUE","30a10a44-32f4-ea11-b882-24ee9a37d45c",-73748799,40607247,"P.S. 253 -QUEENS","1307 CENTRAL AVENUE"
1,0,1,"b48a894e-4afb-ea11-b883-24ee9a37d459","Little Lamb Preschool - RADB - RADB -  - 2 GRIDLEY AVENUE","b58a894e-4afb-ea11-b883-24ee9a37d459",-74159839,40631227,"LITTLE LAMB PRESCHOOL","2 GRIDLEY AVENUE"
1,1,0,"eace496e-31f4-ea11-b882-24ee9a37d45c","P.S. 124 Yung Wing - M124 - M124 - 02M124 - 40 DIVISION STREET","e8ce496e-31f4-ea11-b882-24ee9a37d45c",-73996017,40715097,"P.S. 124 (ECF) - MANHATTAN","40 DIVISION STREET"
3,0,3,"df0d3c5b-30f4-ea11-b882-24ee9a37d45c","P.S. 105 The Blythebourne - K105 - K105 - 20K105 - 1031 59 STREET","e00d3c5b-30f4-ea11-b882-24ee9a37d45c",-74003635,40633320,"P.S. 105 - BROOKLYN","1031 59 STREET"
1,1,0,"d4e8ce00-32f4-ea11-b882-24ee9a37d45c","P.S. 076 William Hallet - Q076 - Q076 - 30Q076 - 36-36 10 Street","d2e8ce00-32f4-ea11-b882-24ee9a37d45c",-73941630,40760862,"P.S. 76 - QUEENS","36-36 10 Street"
1,0,1,"db8fd20d-ebf6-ea11-b883-24ee9a37d459","P.S. K771 - K771 - K014 - 75K771 - 2424 BATCHELDER STREET","eef57030-30f4-ea11-b882-24ee9a37d45c",-73938107,0,"I.S. 14 - BROOKLYN","2424 BATCHELDER STREET"
2,2,0,"378dbfcf-30f4-ea11-b882-24ee9a37d45c","P.S. 770 New American Academy - K770 - K398 - 17K770 - 60 EAST 94 STREET","308dbfcf-30f4-ea11-b882-24ee9a37d45c",-73927979,40663388,"P.S. 398 (UDC) - BROOKLYN","60 EAST 94 STREET"
1,0,1,"8f1f31b6-a262-ec11-b8cf-24ee9a37d45c","Home Instruction - M501 - Q442 - 75M501 - 92-53 Springfield Boulevard","1f4f5ffd-e11e-eb11-b885-24ee9a37d45c",-73737116,0,"DISTRICT 29 PRE-K CENTER @ 92-53 SPRINGFIELD BLVD","92-53 Springfield Boulevard"
1,1,0,"410d6d19-33f4-ea11-b882-24ee9a37d45c","Mott Hall III - X128 - X110 - 09X128 - 580 CROTONA PARK SOUTH","420d6d19-33f4-ea11-b882-24ee9a37d45c",-73900654,40834470,"P.S. 110 - BRONX","580 CROTONA PARK SOUTH"
2,0,2,"aa28a20c-31f4-ea11-b882-24ee9a37d45c","P.S. 089 Cypress Hills - K089 - K814 - 19K089 - 265 WARWICK STREET","a928a20c-31f4-ea11-b882-24ee9a37d45c",-73886712,40677707,"CYPRESS HILLS COMMUNITY SCHOOL - BROOKLYN","265 WARWICK STREET"
2,1,1,"1503cefa-32f4-ea11-b882-24ee9a37d45c","P.S. 042 Claremont - X042 - X042 - 09X042 - 1537 WASHINGTON AVENUE","1103cefa-32f4-ea11-b882-24ee9a37d45c",-73903243,40838636,"P.S. 42 - BRONX","1537 WASHINGTON AVENUE"
2,1,1,"90c280bd-31f4-ea11-b882-24ee9a37d45c","Harvest Collegiate High School - M534 - M883 - 02M534 - 34 WEST 14 STREET","8fc280bd-31f4-ea11-b882-24ee9a37d45c",-73995731,0,"LEGACY HS FOR INTEGR. STUDIES - M","34 WEST 14 STREET"
3,3,0,"56767649-31f4-ea11-b882-24ee9a37d45c","P.S. 042 Benjamin Altman - M042 - M042 - 02M042 - 71 HESTER STREET","51767649-31f4-ea11-b882-24ee9a37d45c",-73990826,40716126,"P.S. 42 - MANHATTAN","71 HESTER STREET"
2,0,2,"2b0410ca-32f4-ea11-b882-24ee9a37d45c","P.S. 050 Frank Hankinson - R050 - R050 - 31R050 - 200 ADELAIDE AVENUE","2c0410ca-32f4-ea11-b882-24ee9a37d45c",-74124332,0,"P.S. 50 - STATEN ISLAND","200 ADELAIDE AVENUE"
2,1,1,"33474313-33f4-ea11-b882-24ee9a37d45c","Ampark Neighborhood - X344 - X095 - 10X344 - 3961 HILLMAN AVENUE","34474313-33f4-ea11-b882-24ee9a37d45c",-73891664,40883049,"P.S. 95 - BRONX","3961 HILLMAN AVENUE"
6,1,5,"6b130a62-e21e-eb11-b885-24ee9a37d45c","South Richmond High School I.S./P.S. 25 - R025 - R119 - 75R025 - 30 Wellbrook Avenue","fd8521d0-32f4-ea11-b882-24ee9a37d45c",-74131181,40604486,"R083 REPLACEMENT @ WELLBROOK AVENUE – STATEN ISLAN","30 Wellbrook Avenue"
2,1,1,"bd69c231-32f4-ea11-b882-24ee9a37d45c","P.S. 212 - Q212 - Q212 - 30Q212 - 34-25 82 STREET","b969c231-32f4-ea11-b882-24ee9a37d45c",-73884458,40753035,"P.S. 212 - QUEENS","34-25 82 STREET"
3,2,1,"e7f22ce2-31f4-ea11-b882-24ee9a37d45c","I.S. 5 - The Walter Crowley Intermediate School - Q005 - Q005 - 24Q005 - 50-40 JACOBUS STREET","9adc32dc-31f4-ea11-b882-24ee9a37d45c",-73888133,0,"I.S. 5 - QUEENS","50-40 JACOBUS STREET"
3,3,0,"668946f4-31f4-ea11-b882-24ee9a37d45c","P.S. 049 Dorothy Bonawit Kole - Q049 - Q049 - 24Q049 - 63-60 80th Street","678946f4-31f4-ea11-b882-24ee9a37d45c",-73875493,40719567,"P.S./I.S. 49 - QUEENS","63-60 80th Street"
2,2,0,"417c21b7-32f4-ea11-b882-24ee9a37d45c","P.S. 6 Corporal Allan F. Kivlehan School - R006 - R006 - 31R006 - 555 PAGE AVENUE","3c7c21b7-32f4-ea11-b882-24ee9a37d45c",-74230118,0,"P.S. 6 - STATEN ISLAND","555 PAGE AVENUE"
4,1,3,"533cbf01-ebf6-ea11-b883-24ee9a37d459","South Richmond High School I.S./P.S. 25 - R025 - R825 - 75R025 - 6581 HYLAN BOULEVARD","77be7adc-32f4-ea11-b882-24ee9a37d45c",-74218688,40512019,"P.S. 25 (MOUNT LORETTO) - S.I.","6581 HYLAN BOULEVARD"
1,0,1,"ec9319d7-ebf6-ea11-b883-24ee9a37d459","South Richmond High School I.S./P.S. 25 - R025 - R445 - 75R025 - 85 ST JOSEPHS AVENUE","515b4cd6-32f4-ea11-b882-24ee9a37d45c",-74141924,40635562,"PORT RICHMOND HS - S. I.","85 ST JOSEPHS AVENUE"
2,2,0,"e7201dab-30f4-ea11-b882-24ee9a37d45c","J.H.S. 278 Marine Park - K278 - K278 - 22K278 - 1925 STUART STREET","e8201dab-30f4-ea11-b882-24ee9a37d45c",-73938721,40606745,"I.S. 278 - BROOKLYN","1925 STUART STREET"
1,1,0,"47fdc1bd-32f4-ea11-b882-24ee9a37d45c","P.S. 8 Shirlee Solomon - R008 - R008 - 31R008 - 112 LINDENWOOD ROAD","48fdc1bd-32f4-ea11-b882-24ee9a37d45c",-74152212,0,"P.S. 8 - STATEN ISLAND","112 LINDENWOOD ROAD"
1,0,1,"c4315367-30f4-ea11-b882-24ee9a37d45c","P.S. 124 Silas B. Dutcher - K124 - K124 - 15K124 - 515 4 AVENUE","c5315367-30f4-ea11-b882-24ee9a37d45c",-73990620,40667464,"P.S. 124 - BROOKLYN","515 4 AVENUE"
1,1,0,"1b0410ca-32f4-ea11-b882-24ee9a37d45c","P.S. 044 Thomas C. Brown - R044 - R044 - 31R044 - 80 MAPLE PARKWAY","1c0410ca-32f4-ea11-b882-24ee9a37d45c",-74157303,40631689,"P.S. 44 - STATEN ISLAND","80 MAPLE PARKWAY"
3,3,0,"9672c880-32f4-ea11-b882-24ee9a37d45c","High School for Construction Trades, Engineering and Architecture - Q650 - Q650 - 27Q650 - 94-06 104TH STREET","8f72c880-32f4-ea11-b882-24ee9a37d45c",-73841475,40689177,"HS FOR CONST.TRADES,ENGG.,& ARCH-Q","94-06 104TH STREET"
4,3,1,"83e03d56-33f4-ea11-b882-24ee9a37d45c","Morris Academy for Collaborative Studies - X297 - X400 - 09X297 - 1110 BOSTON ROAD","82e03d56-33f4-ea11-b882-24ee9a37d45c",-73903920,40827455,"MORRIS HS - X","1110 BOSTON ROAD"
1,0,1,"63fdc1bd-32f4-ea11-b882-24ee9a37d45c","P.S. 020 Port Richmond - R020 - R020 - 31R020 - 161 PARK AVENUE","64fdc1bd-32f4-ea11-b882-24ee9a37d45c",-74132382,0,"P.S. 20 - STATEN ISLAND","161 PARK AVENUE"
2,0,2,"e8d10307-33f4-ea11-b882-24ee9a37d45c","P.S. 068 Bronx - X068 - X068 - 11X068 - 4011 MONTICELLO AVENUE","e9d10307-33f4-ea11-b882-24ee9a37d45c",-73838880,40891603,"P.S. 68 - BRONX","4011 MONTICELLO AVENUE"
2,2,0,"840e6e25-32f4-ea11-b882-24ee9a37d45c","P.S. 169 Bay Terrace - Q169 - Q169 - 25Q169 - 18-25 212 STREET","820e6e25-32f4-ea11-b882-24ee9a37d45c",-73778430,0,"P.S. 169 - QUEENS","18-25 212 STREET"
1,1,0,"1430f69f-ebf6-ea11-b883-24ee9a37d459","P.S. Q224 - Q224 - Q205 - 75Q224 - 75-25 BELL BOULEVARD","a769c231-32f4-ea11-b882-24ee9a37d45c",-73756374,40738008,"P.S. 205 - QUEENS","75-25 BELL BOULEVARD"
1,1,0,"830e93d5-49fb-ea11-b883-24ee9a37d459","SAINT DOMINICS TORCH - XAPI - XAPI -  - 2340 ANDREWS AVE","840e93d5-49fb-ea11-b883-24ee9a37d459",-73906158,40862300,"SAINT DOMINICS TORCH","2340 ANDREWS AVE"
1,1,0,"8e69c231-32f4-ea11-b882-24ee9a37d45c","P.S. 199 Maurice A. Fitzgerald - Q199 - Q199 - 24Q199 - 39-20 48 Avenue","98977d2b-32f4-ea11-b882-24ee9a37d45c",-73926081,40739831,"P.S. 199 - QUEENS","39-20 48 Avenue"
1,0,1,"9201ce37-33f4-ea11-b882-24ee9a37d45c","P.S. 159 Luis Munoz Marin Biling - X159 - X159 - 10X159 - 2315 WASHINGTON AVENUE","9001ce37-33f4-ea11-b882-24ee9a37d45c",-73893136,40855680,"P.S. 159 - BRONX","2315 WASHINGTON AVENUE"
2,1,1,"45474313-33f4-ea11-b882-24ee9a37d45c","Explorations Academy H.S. - X251 - X098 - 12X251 - 1619 BOSTON ROAD","3c474313-33f4-ea11-b882-24ee9a37d45c",-73890591,0,"I.S. 98 - BRONX","1619 BOSTON ROAD"
3,1,2,"41025a42-4afb-ea11-b883-24ee9a37d459","Lenox Hill Neighborhood House - MAMQ - MAMQ -  - 331 EAST 70 STREET","42025a42-4afb-ea11-b883-24ee9a37d459",-73957758,40767081,"LENOX HILL NEIGHBORHOOD HOUSE","331 EAST 70 STREET"
4,4,0,"e8b98b86-30f4-ea11-b882-24ee9a37d45c","M.S. 582 - K582 - K196 - 14K582 - 207 BUSHWICK AVENUE","e9b98b86-30f4-ea11-b882-24ee9a37d45c",-73939385,40708804,"P.S. 196 - BROOKLYN","207 BUSHWICK AVENUE"
2,0,2,"2102926e-32f4-ea11-b882-24ee9a37d45c","Queens Collegiate: A College Board School - Q310 - Q470 - 28Q310 - 167-01 GOTHIC DRIVE","1f02926e-32f4-ea11-b882-24ee9a37d45c",-73798658,40714551,"JAMAICA HS - Q","167-01 GOTHIC DRIVE"
1,0,1,"1830f69f-ebf6-ea11-b883-24ee9a37d459","P.S. Q004 - Q004 - Q213 - 75Q004 - 231-02 67 AVENUE","f8b6c337-32f4-ea11-b882-24ee9a37d45c",-73745390,40747457,"P.S. 213 - QUEENS","231-02 67 AVENUE"
3,3,0,"db454b50-32f4-ea11-b882-24ee9a37d45c","M.S. 358 - Q358 - Q314 - 28Q358 - 88-08 164TH STREET","d5454b50-32f4-ea11-b882-24ee9a37d45c",-73797981,40708698,"P.S./ I.S. 314 - Queens","88-08 164TH STREET"
1,1,0,"26bef08c-32f4-ea11-b882-24ee9a37d45c","P.S. 199 Maurice A. Fitzgerald - Q199 - Q841 - 24Q199 - 48-25 37th Street","27bef08c-32f4-ea11-b882-24ee9a37d45c",-73928640,40739438,"P.S. 199 ANNEX - QUEENS","48-25 37th Street"
1,0,1,"a6778cb8-ebf6-ea11-b883-24ee9a37d459","Pathways to Graduation - Q950 - Q595 - 79Q950 - 162-02 HILLSIDE AVENUE","39b4977a-32f4-ea11-b882-24ee9a37d45c",-73799532,40708204,"AUX. SERV. - JAMAICA LEARN CT - Q","162-02 HILLSIDE AVENUE"
6,4,2,"75bc9674-32f4-ea11-b882-24ee9a37d45c","Grover Cleveland High School - Q485 - Q485 - 24Q485 - 21-27 HIMROD STREET","74bc9674-32f4-ea11-b882-24ee9a37d45c",-73909202,40711881,"GROVER CLEVELAND HS - Q","21-27 HIMROD STREET"
6,2,4,"8f593c87-33f4-ea11-b882-24ee9a37d45c","P.S. 246 Poe Center - X246 - X843 - 10X246 - 2641 Grand Concourse","90593c87-33f4-ea11-b882-24ee9a37d45c",-73895300,40865972,"P.S. 246 (POE CENTER) - BRONX","2641 Grand Concourse"
3,0,3,"eed10307-33f4-ea11-b882-24ee9a37d45c","P.S. 070 Max Schoenfeld - X070 - X070 - 09X070 - 1691 WEEKS AVENUE","efd10307-33f4-ea11-b882-24ee9a37d45c",-73908070,40844236,"P.S. 70 - BRONX","1691 WEEKS AVENUE"
1,0,1,"b5ab074a-33f4-ea11-b882-24ee9a37d45c","P.S. 168 - X168 - X194 - 75X168 - 2365 WATERBURY AVENUE","b6ab074a-33f4-ea11-b882-24ee9a37d45c",-73846594,40835410,"P.S./I.S. 194 - BRONX","2365 WATERBURY AVENUE"
2,1,1,"f721d292-30f4-ea11-b882-24ee9a37d45c","P.S. 230 Doris L. Cohen - K230 - K230 - 15K230 - 1 ALBEMARLE ROAD","f321d292-30f4-ea11-b882-24ee9a37d45c",-73980515,40645609,"P.S. 230 - BROOKLYN","1 ALBEMARLE ROAD"
1,1,0,"21e85c61-30f4-ea11-b882-24ee9a37d45c","P.S. 112 Lefferts Park - K112 - K112 - 20K112 - 7115 15 AVENUE","22e85c61-30f4-ea11-b882-24ee9a37d45c",-74000565,0,"P.S. 112 - BROOKLYN","7115 15 AVENUE"
1,1,0,"fc02cefa-32f4-ea11-b882-24ee9a37d45c","P.S. 035 Franz Siegel - X035 - X035 - 09X035 - 261 EAST 163 STREET","fd02cefa-32f4-ea11-b882-24ee9a37d45c",-73917705,40828009,"P.S. 35 - BRONX","261 EAST 163 STREET"
4,0,4,"6ca9d9c3-32f4-ea11-b882-24ee9a37d45c","I.S. 024 Myra S. Barnes - R024 - R024 - 31R024 - 750 DURANT AVENUE","5bfdc1bd-32f4-ea11-b882-24ee9a37d45c",-74145558,40545490,"I.S. 24 - STATEN ISLAND","750 DURANT AVENUE"
2,1,1,"9401ce37-33f4-ea11-b882-24ee9a37d45c","P.S. 168 - X168 - X160 - 75X168 - 4140 HUTCHINSON RIVER PKWAY EA","9501ce37-33f4-ea11-b882-24ee9a37d45c",-73823816,40864073,"P.S. 160 - BRONX","4140 HUTCHINSON RIVER PKWAY EA"
1,1,0,"100410ca-32f4-ea11-b882-24ee9a37d45c","P.S. 042 Eltingville - R042 - R042 - 31R042 - 380 GENESEE AVENUE","110410ca-32f4-ea11-b882-24ee9a37d45c",-74169038,0,"P.S. 42 - STATEN ISLAND","380 GENESEE AVENUE"
4,4,0,"c5fab455-31f4-ea11-b882-24ee9a37d45c","East Side Community School - M450 - M060 - 01M450 - 420 East 12 Street","c1fab455-31f4-ea11-b882-24ee9a37d45c",-73982472,40729152,"J.H.S. 60 - MANHATTAN","420 East 12 Street"
2,0,2,"e8ed94c3-31f4-ea11-b882-24ee9a37d45c","Beacon High School - M479 - M912 - 03M479 - 522 WEST 44TH STREET","e7ed94c3-31f4-ea11-b882-24ee9a37d45c",-73996262,0,"BEACON HIGH SCHOOL - MANHATTAN","522 WEST 44TH STREET"
1,0,1,"87d95d3c-4afb-ea11-b883-24ee9a37d459","Watson Day Care Center - XAKB - XAGR -  - 1880 WATSON AVENUE","88d95d3c-4afb-ea11-b883-24ee9a37d459",-73861285,40828031,"PRYOR, LEONTINE L. DAY CARE CENTER","1880 WATSON AVENUE"
1,0,1,"0f68ee1e-31f4-ea11-b882-24ee9a37d45c","P.S. 230 Doris L. Cohen - K230 - K908 - 15K230 - 425 Mcdonald Avenue","1068ee1e-31f4-ea11-b882-24ee9a37d45c",-73979161,40643512,"P.S. 230 ANNEX - BROOKLYN","425 Mcdonald Avenue"
3,1,2,"fbcaf33e-6f01-ed11-b8db-24ee9a37d45c","Mosaic Pre-K Center - Q331 - Q369 - 24Q331 - 46-01 111th Street","96ccad4f-f81e-eb11-b885-24ee9a37d45c",-73843333,0,"PRE-K CENTER @ 111TH STREET - QUEENS","46-01 111th Street"
2,1,1,"e417b7f4-32f4-ea11-b882-24ee9a37d45c","Bronx Writing Academy - X323 - X022 - 09X323 - 270 EAST 167 STREET","de17b7f4-32f4-ea11-b882-24ee9a37d45c",-73914350,40832022,"I.S. 22 - BRONX","270 EAST 167 STREET"
4,1,3,"077eed06-32f4-ea11-b882-24ee9a37d45c","P.S. 082 Hammond - Q082 - Q082 - 28Q082 - 88-02 144 STREET","e3e8ce00-32f4-ea11-b882-24ee9a37d45c",-73812200,40703897,"P.S. 82 - QUEENS","88-02 144 STREET"
3,0,3,"445bc58c-30f4-ea11-b882-24ee9a37d45c","P.S. 212 Lady Deborah Moody - K212 - K212 - 21K212 - 87 BAY 49 STREET","455bc58c-30f4-ea11-b882-24ee9a37d45c",-73985368,40587612,"P.S. 212 - BROOKLYN","87 BAY 49 STREET"
2,2,0,"17c73b4a-32f4-ea11-b882-24ee9a37d45c","P.S. 182 Samantha Smith - Q182 - Q277 - 28Q182 - 153-27 88th Avenue","15c73b4a-32f4-ea11-b882-24ee9a37d45c",-73803183,40706750,"PS 182 SAMANTHA SMITH - QUEENS","153-27 88th Avenue"
2,2,0,"1d2ed53d-33f4-ea11-b882-24ee9a37d45c","Baychester Academy - X169 - X169 - 11X169 - 3500 EDSON AVENUE","1e2ed53d-33f4-ea11-b882-24ee9a37d45c",-73839386,40881344,"THE WILLIE ELLA PASCHAL BOWMAN CAMPUS - X","3500 EDSON AVENUE"
1,1,0,"3c9f4974-31f4-ea11-b882-24ee9a37d45c","P.S. 142 Amalia Castro - M142 - M142 - 01M142 - 100 ATTORNEY STREET","379f4974-31f4-ea11-b882-24ee9a37d45c",-73984116,40718121,"P.S. 142 - MANHATTAN","100 ATTORNEY STREET"
3,3,0,"4de61462-31f4-ea11-b882-24ee9a37d45c","Innovation Charter High School - M433 - M099 - 84M433 - 410 EAST 100 STREET","3de61462-31f4-ea11-b882-24ee9a37d45c",-73942154,40785107,"I.S. 99 - MANHATTAN","410 EAST 100 STREET"
1,0,1,"9d48b1f5-eaf6-ea11-b883-24ee9a37d459","P.S. K077 - K077 - K902 - 75K077 - 62 PARK PLACE","2604d718-31f4-ea11-b882-24ee9a37d45c",-73976648,40678809,"P.S. 77 ANNEX - BROOKLYN","62 PARK PLACE"
1,0,1,"5f6e70b7-31f4-ea11-b882-24ee9a37d45c","High School of Economics and Finance - M489 - M833 - 02M489 - 100 TRINITY PLACE","606e70b7-31f4-ea11-b882-24ee9a37d45c",-74012328,40709270,"HS FOR ECONOMICS & FINANCE - M","100 TRINITY PLACE"
4,3,1,"0ffc3df4-30f4-ea11-b882-24ee9a37d45c","All City Leadership Secondary School - K554 - K554 - 32K554 - 321 Palmetto Street","10fc3df4-30f4-ea11-b882-24ee9a37d45c",-73913172,40697378,"ALL CITY LEADERSHIP SECONDARY SCHOOL - BROOKLYN","321 Palmetto Street"
1,0,1,"d8e13320-ebf6-ea11-b883-24ee9a37d459","P.S. K077 - K077 - K164 - 75K077 - 4211 14 AVENUE","36ebaa73-30f4-ea11-b882-24ee9a37d45c",-73985739,40637101,"P.S. 164 - BROOKLYN","4211 14 AVENUE"
1,0,1,"b9edf392-32f4-ea11-b882-24ee9a37d45c","P.S. 099 Kew Gardens - Q099 - Q866 - 28Q099 - 83-34 Kew Gardens Road","baedf392-32f4-ea11-b882-24ee9a37d45c",-73827276,40709492,"P.S. 99 ANNEX - QUEENS","83-34 Kew Gardens Road"
3,0,3,"f43159fa-30f4-ea11-b882-24ee9a37d45c","District 20 Pre-K Center - K768 - K613 - 20K768 - 369 93rd Street","f53159fa-30f4-ea11-b882-24ee9a37d45c",-74031046,0,"PRE-K CENTER @93RD STREET - BROOKLYN","369 93rd Street"
1,0,1,"4c9f4974-31f4-ea11-b882-24ee9a37d45c","P.S. 145, The Bloomingdale School - M145 - M145 - 03M145 - 150 West 105 Street","4a9f4974-31f4-ea11-b882-24ee9a37d45c",-73965611,40799098,"P.S. 145 - MANHATTAN","150 West 105 Street"
1,0,1,"3e0d6d19-33f4-ea11-b882-24ee9a37d45c","P.S. 107 - X107 - X107 - 08X107 - 1695 SEWARD AVENUE","340d6d19-33f4-ea11-b882-24ee9a37d45c",-73868735,40819221,"P.S. 107 - BRONX","1695 SEWARD AVENUE"
3,0,3,"f6b98b86-30f4-ea11-b882-24ee9a37d45c","P.S. 197 - The Kings Highway Academy - K197 - K197 - 22K197 - 1599 EAST 22 STREET","f7b98b86-30f4-ea11-b882-24ee9a37d45c",-73951398,40612339,"P.S. 197 - BROOKLYN","1599 EAST 22 STREET"
14,6,8,"399ebaee-32f4-ea11-b882-24ee9a37d45c","P.S. 019 Judith K. Weiss - X019 - X019 - 11X019 - 311 East 237 Street","319ebaee-32f4-ea11-b882-24ee9a37d45c",-73866949,40899351,"P.S. 19 - BRONX","311 East 237 Street"
4,3,1,"b7ab074a-33f4-ea11-b882-24ee9a37d45c","P.S./M.S. 194 - X194 - X194 - 11X194 - 2365 WATERBURY AVENUE","b6ab074a-33f4-ea11-b882-24ee9a37d45c",-73846594,40835410,"P.S./I.S. 194 - BRONX","2365 WATERBURY AVENUE"
2,1,1,"d1f57030-30f4-ea11-b882-24ee9a37d45c","P.S. 007 Abraham Lincoln - K007 - K007 - 19K007 - 858 JAMAICA AVENUE","fcc1392a-30f4-ea11-b882-24ee9a37d45c",-73872983,40689213,"P.S. 7 - BROOKLYN","858 JAMAICA AVENUE"
1,1,0,"367eed06-32f4-ea11-b882-24ee9a37d45c","P.S. 099 Kew Gardens - Q099 - Q099 - 28Q099 - 82-37 KEW GARDENS ROAD","377eed06-32f4-ea11-b882-24ee9a37d45c",-73827722,40711502,"P.S. 99 - QUEENS","82-37 KEW GARDENS ROAD"
2,1,1,"5d3cbf01-ebf6-ea11-b883-24ee9a37d459","P.S. 087 Bronx - X087 - X087 - 11X087 - 1935 BUSSING AVENUE","510b210d-33f4-ea11-b882-24ee9a37d45c",-73846198,40895741,"P.S. 87 - BRONX","1935 BUSSING AVENUE"
1,0,1,"bebfa431-33f4-ea11-b882-24ee9a37d45c","South Bronx Preparatory: A College Board School - X221 - X149 - 07X221 - 360 EAST 145 STREET","bcbfa431-33f4-ea11-b882-24ee9a37d45c",-73920851,40813612,"J.H.S. 149 - BRONX","360 EAST 145 STREET"
1,0,1,"6b36d900-33f4-ea11-b882-24ee9a37d45c","Frederick Douglass Academy V. Middle School - X273 - X057 - 12X273 - 2111 CROTONA AVENUE","6c36d900-33f4-ea11-b882-24ee9a37d45c",-73888987,40848748,"P.S. 57 - BRONX","2111 CROTONA AVENUE"
2,2,0,"2fff3d8d-33f4-ea11-b882-24ee9a37d45c","Community School for Social Justice - X427 - X884 - 07X427 - 350 Gerard Avenue","2dff3d8d-33f4-ea11-b882-24ee9a37d45c",-73929960,40815712,"HEALTH OPPORTUNITIES HS - X","350 Gerard Avenue"
1,1,0,"0db7c337-32f4-ea11-b882-24ee9a37d45c","P.S. 220 Edward Mandel - Q220 - Q220 - 28Q220 - 62-10 108 STREET","0eb7c337-32f4-ea11-b882-24ee9a37d45c",-73852621,40736314,"P.S. 220 - QUEENS","62-10 108 STREET"
1,1,0,"610c394e-83ef-eb11-b8b1-24ee9a37d45c","KIPP Beyond Charter School - M389 - MACU - 84M389 - 535 WEST 121 STREET","620c394e-83ef-eb11-b8b1-24ee9a37d45c",-73960761,40811107,"CORPUS CHRISTI SCHOOL","535 WEST 121 STREET"
1,1,0,"87d810ab-31f4-ea11-b882-24ee9a37d45c","High School of Hospitality Management - M296 - M535 - 02M296 - 525 WEST 50TH STREET","f137fba4-31f4-ea11-b882-24ee9a37d45c",-73992700,40765474,"PARK WEST HS (ECF) - MANHATTAN","525 WEST 50TH STREET"
2,2,0,"5c2f77fa-31f4-ea11-b882-24ee9a37d45c","P.S. 060 Woodhaven - Q060 - Q060 - 27Q060 - 91-02 88 AVENUE","8e8946f4-31f4-ea11-b882-24ee9a37d45c",-73852792,40691467,"P.S. 60 - QUEENS","91-02 88 AVENUE"
2,2,0,"1378931f-33f4-ea11-b882-24ee9a37d45c","P.S. X188 - X188 - X120 - 75X188 - 890 CAULDWELL AVENUE","1478931f-33f4-ea11-b882-24ee9a37d45c",-73906739,0,"I.S. 301 - BRONX","890 CAULDWELL AVENUE"
5,0,5,"380b210d-33f4-ea11-b882-24ee9a37d45c","J.H.S. 080 The Mosholu Parkway - X080 - X080 - 10X080 - 149 EAST MOSHOLU PKWY N","370b210d-33f4-ea11-b882-24ee9a37d45c",-73881245,0,"I.S. 80/P.S. 280 - BRONX","3202 STEUBEN AVENUE"
2,1,1,"9601ce37-33f4-ea11-b882-24ee9a37d45c","P.S. 160 Walt Disney - X160 - X160 - 11X160 - 4140 HUTCHINSON RIVER PKWAY EA","9501ce37-33f4-ea11-b882-24ee9a37d45c",-73823816,40864073,"P.S. 160 - BRONX","4140 HUTCHINSON RIVER PKWAY EA"
1,1,0,"9e9c11e8-30f4-ea11-b882-24ee9a37d45c","Academy for College Preparation and Career Exploration: A College Board School - K382 - K465 - 17K382 - 911 FLATBUSH AVENUE","9d9c11e8-30f4-ea11-b882-24ee9a37d45c",-73957173,0,"ERASMUS HALL CAMPUS - K","911 FLATBUSH AVENUE"
2,2,0,"ca8521d0-32f4-ea11-b882-24ee9a37d45c","P.S. 060 Alice Austen - R060 - R060 - 31R060 - 55 Merrill Avenue","cb8521d0-32f4-ea11-b882-24ee9a37d45c",-74162634,0,"P.S. 60 - STATEN ISLAND","55 Merrill Avenue"
7,6,1,"f5454b50-32f4-ea11-b882-24ee9a37d45c","P.S. 376 - Q376 - Q332 - 26Q376 - 210-21 48 AVENUE","f6454b50-32f4-ea11-b882-24ee9a37d45c",-73770314,40754954,"Bayside Hills School of Excellence","210-21 48 AVENUE"
2,2,0,"7303194f-30f4-ea11-b882-24ee9a37d45c","P.S. 69 Vincent D. Grippo School - K069 - K069 - 20K069 - 6302 9TH AVENUE","7203194f-30f4-ea11-b882-24ee9a37d45c",-74009752,40632392,"P.S. 69 - BROOKLYN","6302 9TH AVENUE"
1,0,1,"41767649-31f4-ea11-b882-24ee9a37d45c","P.S. 138 - M138 - M033 - 75M138 - 281 9 AVENUE","42767649-31f4-ea11-b882-24ee9a37d45c",-74000238,40749014,"P.S. 33 - MANHATTAN","281 9 AVENUE"
3,0,3,"0ad8cf12-31f4-ea11-b882-24ee9a37d45c","New Voices School of Academic & Creative Arts - K443 - K845 - 15K443 - 330 18 STREET","0bd8cf12-31f4-ea11-b882-24ee9a37d45c",-73988743,40660805,"P.S. 295 - BROOKLYN","330 18 STREET"
2,1,1,"ed17b7f4-32f4-ea11-b882-24ee9a37d45c","P.S. 024 Spuyten Duyvil - X024 - X024 - 10X024 - 660 WEST 236 STREET","ee17b7f4-32f4-ea11-b882-24ee9a37d45c",-73915114,40886922,"P.S. 24 - BRONX","660 WEST 236 STREET"
2,0,2,"e7883319-32f4-ea11-b882-24ee9a37d45c","P.S. 146 Howard Beach - Q146 - Q146 - 27Q146 - 98-01 159 AVENUE","e8883319-32f4-ea11-b882-24ee9a37d45c",-73834896,40660531,"P.S. 146 - QUEENS","98-01 159 AVENUE"
1,0,1,"6fe9a5af-4afb-ea11-b883-24ee9a37d459","Kingsbridge Heights Community Center - XALV - XASJ -  - 295 WEST 231 STREET","70e9a5af-4afb-ea11-b883-24ee9a37d459",-73908163,40880706,"Kingsbridge Innovative Design Charter School","295 WEST 231 STREET"
3,0,3,"60507380-31f4-ea11-b882-24ee9a37d45c","P.S. 138 - M138 - M189 - 75M138 - 2580 AMSTERDAM AVENUE","5f507380-31f4-ea11-b882-24ee9a37d45c",-73928048,40853045,"P.S. 189 - MANHATTAN","2580 AMSTERDAM AVENUE"
2,0,2,"02ee94c3-31f4-ea11-b882-24ee9a37d45c","Thurgood Marshall Academy for Learning and Social Change - M670 - M970 - 05M670 - 200-214 WEST 135TH STREET","03ee94c3-31f4-ea11-b882-24ee9a37d45c",-73944299,0,"THURGOOD MARSHALL ACAD. - M","200-214 WEST 135TH STREET"
1,0,1,"555bc58c-30f4-ea11-b882-24ee9a37d45c","P.S. 216 Arturo Toscanini - K216 - K216 - 21K216 - 350 AVENUE X","565bc58c-30f4-ea11-b882-24ee9a37d45c",-73969647,40590000,"P.S. 216 - BROOKLYN","350 AVENUE X"
1,1,0,"ce92e6d5-30f4-ea11-b882-24ee9a37d45c","Cypress Hills Collegiate Preparatory School - K659 - K420 - 19K659 - 999 JAMAICA AVENUE","c692e6d5-30f4-ea11-b882-24ee9a37d45c",-73869305,40693002,"FRANKLIN K. LANE HS - K","999 JAMAICA AVENUE"
1,1,0,"1806003e-32f4-ea11-b882-24ee9a37d45c","Academy for New Americans - Q235 - Q234 - 30Q235 - 30-14 30 STREET","1506003e-32f4-ea11-b882-24ee9a37d45c",-73923044,40766898,"P.S. 234 - QUEENS","30-14 30 STREET"
2,2,0,"ec09e2e1-30f4-ea11-b882-24ee9a37d45c","East Williamsburg Scholars Academy - K477 - K450 - 14K477 - 850 GRAND STREET","e909e2e1-30f4-ea11-b882-24ee9a37d45c",-73938921,40711134,"GRAND STREET CAMPUS (OLD E.D.HS)- K","850 GRAND STREET"
1,0,1,"9b48b1f5-eaf6-ea11-b883-24ee9a37d459","P.S. 36 - K036 - K857 - 75K036 - 2045 Linden Boulevard","21d8cf12-31f4-ea11-b882-24ee9a37d45c",-73887195,40660465,"P.S. 36 ANNEX - BROOKLYN","2045 Linden Boulevard"
2,0,2,"a4bfa431-33f4-ea11-b882-24ee9a37d45c","P186X Walter J. Damrosch School - X186 - X146 - 75X186 - 968 CAULDWELL AVENUE","a5bfa431-33f4-ea11-b882-24ee9a37d45c",-73905734,40824717,"P.S. 146 - BRONX","968 CAULDWELL AVENUE"
2,0,2,"bab36d80-30f4-ea11-b882-24ee9a37d45c","The SEEALL Academy - K180 - K180 - 20K180 - 5601 16 AVENUE","b8b36d80-30f4-ea11-b882-24ee9a37d45c",-73989250,40626454,"P.S. 180 - BROOKLYN","5601 16 AVENUE"
1,1,0,"2278931f-33f4-ea11-b882-24ee9a37d45c","The School for Inquiry and Social Justice - X337 - X123 - 08X337 - 1025 MORRISON AVENUE","2378931f-33f4-ea11-b882-24ee9a37d45c",-73874162,40824989,"I.S. 123 - BRONX","1025 MORRISON AVENUE"
5,0,5,"38e61462-31f4-ea11-b882-24ee9a37d45c","P.S. 092 Mary McLeod Bethune - M092 - M092 - 05M092 - 222 WEST 134 STREET","36e61462-31f4-ea11-b882-24ee9a37d45c",-73945838,40814917,"P.S. 92 - MANHATTAN","222 WEST 134 STREET"
1,0,1,"32a198c3-30f4-ea11-b882-24ee9a37d45c","P.S. 346 Abe Stark - K346 - K346 - 19K346 - 1400 PENNSYLVANIA AVENUE","30a198c3-30f4-ea11-b882-24ee9a37d45c",-73881997,40646640,"P.S. 346 - BROOKLYN","1400 PENNSYLVANIA AVENUE"
4,3,1,"e60d3c5b-30f4-ea11-b882-24ee9a37d45c","P.S. 107 John W. Kimball - K107 - K107 - 15K107 - 1301 8 AVENUE","e70d3c5b-30f4-ea11-b882-24ee9a37d45c",-73981181,40662945,"P.S. 107 - BROOKLYN","1301 8 AVENUE"
2,1,1,"0dcf496e-31f4-ea11-b882-24ee9a37d45c","Emma Lazarus High School - M394 - M131 - 02M394 - 100 HESTER STREET","03cf496e-31f4-ea11-b882-24ee9a37d45c",-73993607,0,"I.S. 131 - MANHATTAN","100 HESTER STREET"
1,1,0,"66b50aa5-30f4-ea11-b882-24ee9a37d45c","P.S. 261 Zipporiah Mills - K261 - K261 - 15K261 - 314 PACIFIC STREET","5fb50aa5-30f4-ea11-b882-24ee9a37d45c",-73988667,40687218,"P.S. 261 - BROOKLYN","314 PACIFIC STREET"
1,0,1,"6c2f77fa-31f4-ea11-b882-24ee9a37d45c","P.S. 064 Joseph P. Addabbo - Q064 - Q064 - 27Q064 - 82-01 101 AVENUE","6d2f77fa-31f4-ea11-b882-24ee9a37d45c",-73856956,40681901,"P.S. 64 - QUEENS","82-01 101 AVENUE"
1,1,0,"762b3eee-30f4-ea11-b882-24ee9a37d45c","Academy for Conservation and the Environment - K637 - K515 - 18K637 - 6565 FLATLANDS AVENUE","6d2b3eee-30f4-ea11-b882-24ee9a37d45c",-73916927,40634451,"SOUTH SHORE EDUCATIONAL CAMPUS - K","6565 FLATLANDS AVENUE"
2,0,2,"3fde5eb7-30f4-ea11-b882-24ee9a37d45c","P.S. 298 Dr. Betty Shabazz - K298 - K298 - 23K298 - 85 WATKINS STREET","3dde5eb7-30f4-ea11-b882-24ee9a37d45c",-73907718,40671015,"P.S. 298 - BROOKLYN","85 WATKINS STREET"
1,1,0,"ba56635c-33f4-ea11-b882-24ee9a37d45c","Pelham Lab High School - X320 - X405 - 08X320 - 3000 EAST TREMONT AVENUE","b556635c-33f4-ea11-b882-24ee9a37d45c",-73839583,40839775,"HERBERT H. LEHMAN HS - X","3000 EAST TREMONT AVENUE"
2,2,0,"dd8a0044-33f4-ea11-b882-24ee9a37d45c","P.S. 175 City Island - X175 - X175 - 11X175 - 200 CITY ISLAND AVENUE","de8a0044-33f4-ea11-b882-24ee9a37d45c",-73783540,40844353,"P.S. 175 - BRONX","200 CITY ISLAND AVENUE"
1,0,1,"3b3cbf01-ebf6-ea11-b883-24ee9a37d459","P.S. Q233 - Q233 - Q686 - 75Q233 - 91-30 METROPOLITAN AVENUE","a372c880-32f4-ea11-b882-24ee9a37d45c",-73855543,0,"METROPOLITAN AVENUE CAMPUS - QUEENS","91-30 METROPOLITAN AVENUE"
2,0,2,"27005d7a-31f4-ea11-b882-24ee9a37d45c","P.S. 163 Alfred E. Smith - M163 - M163 - 03M163 - 163 West 97 Street","26005d7a-31f4-ea11-b882-24ee9a37d45c",-73968470,40795163,"P.S. 163 - MANHATTAN","163 West 97 Street"
1,1,0,"b34816e2-e11e-eb11-b885-24ee9a37d45c","Mosaic Pre-K Center - Q331 - Q364 - 24Q331 - 75-01 Broadway","b44816e2-e11e-eb11-b885-24ee9a37d45c",-73890006,0,"3K CENTER @ BROADWAY - QUEENS","75-01 Broadway"
1,0,1,"d3d10307-33f4-ea11-b882-24ee9a37d45c","Lucero Elementary School - X311 - X064 - 09X311 - 1425 WALTON AVENUE","d4d10307-33f4-ea11-b882-24ee9a37d45c",-73915879,40840400,"P.S. 64 - BRONX","1425 WALTON AVENUE"
2,1,1,"78977d2b-32f4-ea11-b882-24ee9a37d45c","J.H.S. 190 Russell Sage - Q190 - Q190 - 28Q190 - 68-17 AUSTIN STREET","75977d2b-32f4-ea11-b882-24ee9a37d45c",-73851700,40723478,"J.H.S. 190 - QUEENS","68-17 AUSTIN STREET"
1,1,0,"45332a24-4afb-ea11-b883-24ee9a37d459","SAMUEL FIELD YM & YWHA (LITTLE NECK) - QAKH - QAKH -  - 58-20 LITTLE NECK PARKWAY","46332a24-4afb-ea11-b883-24ee9a37d459",-73723308,40760998,"Little Meadows- Samuel Field","58-20 LITTLE NECK PARKWAY"
1,0,1,"7d53dd74-33f4-ea11-b882-24ee9a37d45c","Bronx Compass High School - X561 - X450 - 08X561 - 1980 LAFAYETTE AVENUE","62ffcc6e-33f4-ea11-b882-24ee9a37d45c",-73855930,40821218,"Adlai E. Stevenson Educational Campus","1980 LAFAYETTE AVENUE"
1,1,0,"4f474313-33f4-ea11-b882-24ee9a37d45c","P.S. 100 Isaac Clason - X100 - X100 - 08X100 - 800 TAYLOR AVENUE","50474313-33f4-ea11-b882-24ee9a37d45c",-73862760,40822552,"P.S. 100 - BRONX","800 TAYLOR AVENUE"
1,1,0,"cc8442ee-31f4-ea11-b882-24ee9a37d45c","P.S. 033 Edward M. Funk - Q033 - Q033 - 29Q033 - 91-37 222 STREET","cd8442ee-31f4-ea11-b882-24ee9a37d45c",-73734102,40727172,"P.S. 33 - QUEENS","91-37 222 STREET"
2,2,0,"f1454b50-32f4-ea11-b882-24ee9a37d45c","East Elmhurst Community School - Q329 - Q329 - 30Q329 - 26-25 97th Street","f0454b50-32f4-ea11-b882-24ee9a37d45c",-73872244,0,"EAST ELMHURST COMMUNITY SCHOOL - QUEENS","26-25 97th Street"
1,0,1,"15a31781-33f4-ea11-b882-24ee9a37d45c","P.S. X188 - X188 - X790 - 75X188 - 730 CONCOURSE VILLAGE WEST","0ea31781-33f4-ea11-b882-24ee9a37d45c",-73922366,40821828,"MOTT HAVEN EDUCATIONAL CAMPUS - BRONX","730 CONCOURSE VILLAGE WEST"
1,1,0,"69c130ae-6c0c-ed11-b091-088e901ef405","P.S. X010 - X010 - X104 - 75X010 - 1449 SHAKESPEARE AVENUE","360d6d19-33f4-ea11-b882-24ee9a37d45c",-73920826,40843453,"P.S. 199 - BRONX","1449 SHAKESPEARE AVENUE"
2,2,0,"66a5db98-30f4-ea11-b882-24ee9a37d45c","P.S. 238 Anne Sullivan - K238 - K238 - 21K238 - 1633 EAST 8 STREET","65a5db98-30f4-ea11-b882-24ee9a37d45c",-73964586,40608801,"P.S. 238 - BROOKLYN","1633 EAST 8 STREET"
1,1,0,"df37fba4-31f4-ea11-b882-24ee9a37d45c","Manhattan Early College School for Advertising - M280 - M520 - 02M280 - 411 PEARL STREET","e037fba4-31f4-ea11-b882-24ee9a37d45c",-74000851,40711441,"MURRY BERGTRAUM HS (ECF) - M","411 PEARL STREET"
2,2,0,"43de5eb7-30f4-ea11-b882-24ee9a37d45c","P.S. 299 Thomas Warren Field - K299 - K299 - 32K299 - 88 WOODBINE STREET","44de5eb7-30f4-ea11-b882-24ee9a37d45c",-73917899,40690755,"P.S. 299 - BROOKLYN","88 WOODBINE STREET"
1,0,1,"c6bfa431-33f4-ea11-b882-24ee9a37d45c","P.S./M.S. 031 The William Lloyd Garrison - X031 - X151 - 07X031 - 250 EAST 156 STREET","c1bfa431-33f4-ea11-b882-24ee9a37d45c",-73921140,40822574,"I.S. 151 - BRONX","250 EAST 156 STREET"
2,1,1,"907e21a6-ebf6-ea11-b883-24ee9a37d459","P.S./I.S. 78Q - Q078 - Q312 - 30Q078 - 46-08 5TH STREET","cf454b50-32f4-ea11-b882-24ee9a37d45c",-73955145,40747077,"P.S./.IS. 78 - QUEENS","46-08 5TH STREET"
1,0,1,"6f8d8486-31f4-ea11-b882-24ee9a37d45c","Harlem Village Academy West Charter School - M709 - M194 - 84M709 - 244 WEST 144 STREET","708d8486-31f4-ea11-b882-24ee9a37d45c",-73941111,40821208,"P.S. 194 - MANHATTAN","244 WEST 144 STREET"
1,1,0,"3d474313-33f4-ea11-b882-24ee9a37d45c","P.S. 096 Richard Rodgers - X096 - X096 - 11X096 - 2385 OLINVILLE AVENUE","3e474313-33f4-ea11-b882-24ee9a37d45c",-73868986,40860730,"P.S. 96 - BRONX","2385 OLINVILLE AVENUE"
2,1,1,"e09b4c1f-32f4-ea11-b882-24ee9a37d45c","P.S. 153 Maspeth Elem - Q153 - Q153 - 24Q153 - 60-02 60 LANE","e19b4c1f-32f4-ea11-b882-24ee9a37d45c",-73904463,40716296,"P.S. 153 - QUEENS","60-02 60 LANE"
3,0,3,"d59319d7-ebf6-ea11-b883-24ee9a37d459","P.S. R373 - R373 - R058 - 75R373 - 77 MARSH AVENUE","2a0410ca-32f4-ea11-b882-24ee9a37d45c",-74160867,0,"P.S. 58 - STATEN ISLAND","77 MARSH AVENUE"
1,1,0,"24ebaa73-30f4-ea11-b882-24ee9a37d45c","P.S./I.S. 157 The Benjamin Franklin Health & Science Academy - K157 - K157 - 14K157 - 850 KENT AVENUE","23ebaa73-30f4-ea11-b882-24ee9a37d45c",-73959999,40695397,"P.S. 157 - BROOKLYN","850 KENT AVENUE"
1,1,0,"180410ca-32f4-ea11-b882-24ee9a37d45c","I.S. 49 Berta A. Dreyfus - R049 - R049 - 31R049 - 101 WARREN STREET","190410ca-32f4-ea11-b882-24ee9a37d45c",-74080695,0,"I.S. 49 - STATEN ISLAND","101 WARREN STREET"
1,0,1,"63d1192e-7f67-ec11-b8cf-24ee9a37d45c","MILAGROS M. MATIAS - 2 - KDZX - KDTQ -  - 795 Bushwick Avenue","64d1192e-7f67-ec11-b8cf-24ee9a37d45c",-73928337,40695162,"795 BUSHWICK AVE","795 Bushwick Avenue"
1,1,0,"499f4974-31f4-ea11-b882-24ee9a37d45c","West Prep Academy - M421 - M145 - 03M421 - 150 West 105 Street","4a9f4974-31f4-ea11-b882-24ee9a37d45c",-73965611,40799098,"P.S. 145 - MANHATTAN","150 West 105 Street"
2,2,0,"1f6e3d68-31f4-ea11-b882-24ee9a37d45c","Tag Young Scholars - M012 - M117 - 04M012 - 240 EAST 109 STREET","1b6e3d68-31f4-ea11-b882-24ee9a37d45c",-73942285,40792556,"J.H.S. 117 - MANHATTAN","240 EAST 109 STREET"
1,1,0,"309f4974-31f4-ea11-b882-24ee9a37d45c","Eagle Academy for Young Men of Harlem - M148 - M136 - 05M148 - 6 EDGECOMBE AVENUE","15cf496e-31f4-ea11-b882-24ee9a37d45c",-73947151,40817228,"I.S. 136 - MANHATTAN","6 EDGECOMBE AVENUE"
1,1,0,"4e2b3eee-30f4-ea11-b882-24ee9a37d45c","The Christa McAuliffe School\I.S. 187 - K187 - K486 - 20K187 - 1171 65 STREET","4f2b3eee-30f4-ea11-b882-24ee9a37d45c",-74003883,40627929,"I.S. 187 - BROOKLYN","1171 65 STREET"
2,2,0,"45ebaa73-30f4-ea11-b882-24ee9a37d45c","Van Siclen Community Middle School - K654 - K166 - 19K654 - 800 VAN SICLEN AVE","41ebaa73-30f4-ea11-b882-24ee9a37d45c",-73885704,40659934,"I.S. 166 - BROOKLYN","800 VAN SICLEN AVE"
1,1,0,"58e61462-31f4-ea11-b882-24ee9a37d45c","P.S. 102 Jacques Cartier - M102 - M102 - 04M102 - 315 EAST 113 STREET","56e61462-31f4-ea11-b882-24ee9a37d45c",-73938418,40795000,"P.S. 102 - MANHATTAN","315 EAST 113 STREET"
2,0,2,"12af1f69-ebf6-ea11-b883-24ee9a37d459","District 2 Pre-K Center - M391 - M474 - 02M391 - 252 EAST 57 STREET","41a6ba98-31f4-ea11-b882-24ee9a37d45c",-73965878,0,"PRE-K CENTER @ EAST 57 STREET - MANHATTAN","252 EAST 57 STREET"
1,1,0,"2806003e-32f4-ea11-b882-24ee9a37d45c","P.S. 239 - Q239 - Q239 - 24Q239 - 17-15 WEIRFIELD STREET","2606003e-32f4-ea11-b882-24ee9a37d45c",-73903838,40699431,"P.S. 239 - QUEENS","17-15 WEIRFIELD STREET"
1,1,0,"d8315367-30f4-ea11-b882-24ee9a37d45c","P.S. 131 Brooklyn - K131 - K131 - 15K131 - 4305 FT HAMILTON PARKWAY","d9315367-30f4-ea11-b882-24ee9a37d45c",-73993247,40640728,"P.S. 131 - BROOKLYN","4305 FT HAMILTON PARKWAY"
1,1,0,"5f698396-6b01-ed11-b8db-24ee9a37d45c","The Mott Hall School - M223 - M164 - 06M223 - 401 WEST 164 STREET","2a005d7a-31f4-ea11-b882-24ee9a37d45c",-73937263,40836982,"I.S. 164 - MANHATTAN","401 WEST 164 STREET"
2,2,0,"2e9ebaee-32f4-ea11-b882-24ee9a37d45c","P.S. 291 - X291 - X015 - 10X291 - 2195 ANDREWS AVENUE","219ebaee-32f4-ea11-b882-24ee9a37d45c",-73909763,40859243,"P.S. 15 - BRONX","2195 ANDREWS AVENUE"
1,1,0,"9241e65b-31f4-ea11-b882-24ee9a37d45c","Wadleigh Secondary School for the Performing & Visual Arts - M415 - M088 - 03M415 - 215 WEST 114 STREET","8841e65b-31f4-ea11-b882-24ee9a37d45c",-73954152,40802610,"I.S. 88 - MANHATTAN","215 WEST 114 STREET"
3,3,0,"fef22ce2-31f4-ea11-b882-24ee9a37d45c","P.S. 011 Kathryn Phelan - Q011 - Q011 - 30Q011 - 54-25 SKILLMAN AVENUE","fff22ce2-31f4-ea11-b882-24ee9a37d45c",-73909032,40746127,"P.S. 11 - QUEENS","54-25 SKILLMAN AVENUE"
1,0,1,"1e02926e-32f4-ea11-b882-24ee9a37d45c","Hillside Arts & Letters Academy - Q325 - Q470 - 28Q325 - 167-01 GOTHIC DRIVE","1f02926e-32f4-ea11-b882-24ee9a37d45c",-73798658,40714551,"JAMAICA HS - Q","167-01 GOTHIC DRIVE"
1,1,0,"cd8521d0-32f4-ea11-b882-24ee9a37d45c","I.S. 061 William A Morris - R061 - R061 - 31R061 - 445 CASTLETON AVENUE","460410ca-32f4-ea11-b882-24ee9a37d45c",-74097941,40634497,"I.S. 61 - STATEN ISLAND","445 CASTLETON AVENUE"
1,1,0,"e4e0838c-31f4-ea11-b882-24ee9a37d45c","Sixth Avenue Elementary School - M340 - M340 - 02M340 - 64 WEST 17 STREET","e3e0838c-31f4-ea11-b882-24ee9a37d45c",-73995534,40739145,"THE SIXTH AVENUE EDUCATIONAL CAMPUS - MANHATTAN","64 WEST 17 STREET"
1,1,0,"9969c231-32f4-ea11-b882-24ee9a37d45c","J.H.S. 202 Robert H. Goddard - Q202 - Q202 - 27Q202 - 138-30 LAFAYETTE STREET","9169c231-32f4-ea11-b882-24ee9a37d45c",-73845992,0,"I.S. 202 - QUEENS","138-30 LAFAYETTE STREET"
2,0,2,"ecaeb707-ecf6-ea11-b883-24ee9a37d459","P.S. X010 - X010 - X817 - 75X010 - 1680 Hoe Avenue","27a31781-33f4-ea11-b882-24ee9a37d45c",-73887227,40835849,"P.S. 811 ANNEX - BRONX","1680 Hoe Avenue"
1,1,0,"b6fab455-31f4-ea11-b882-24ee9a37d45c","University Neighborhood Middle School - M332 - M056 - 01M332 - 220 HENRY STREET","affab455-31f4-ea11-b882-24ee9a37d45c",-73986051,40713362,"J.H.S. 56 - MANHATTAN","220 HENRY STREET"
1,1,0,"2fa198c3-30f4-ea11-b882-24ee9a37d45c","Frederick Douglass Academy VIII Middle School - K452 - K346 - 19K452 - 1400 PENNSYLVANIA AVENUE","30a198c3-30f4-ea11-b882-24ee9a37d45c",-73881997,40646640,"P.S. 346 - BROOKLYN","1400 PENNSYLVANIA AVENUE"
1,0,1,"d4b36d80-30f4-ea11-b882-24ee9a37d45c","P.S. 188 Michael E. Berdy - K188 - K188 - 21K188 - 3314 Neptune Avenue","cdb36d80-30f4-ea11-b882-24ee9a37d45c",-74000489,40576733,"P.S. 188 - BROOKLYN","3314 Neptune Avenue"
3,3,0,"f0883319-32f4-ea11-b882-24ee9a37d45c","P.S. 148 Queens - Q148 - Q148 - 30Q148 - 89-02 32 AVENUE","ef883319-32f4-ea11-b882-24ee9a37d45c",-73878638,40757629,"P.S. 148 - QUEENS","89-02 32 AVENUE"
1,0,1,"c6b66262-32f4-ea11-b882-24ee9a37d45c","Business Technology Early College High School - Q315 - Q435 - 26Q315 - 230-17 HILLSIDE AVENUE","c4b66262-32f4-ea11-b882-24ee9a37d45c",-73739726,0,"MARTIN VAN BUREN HS - QUEENS","230-17 HILLSIDE AVENUE"
2,1,1,"16e2abc9-30f4-ea11-b882-24ee9a37d45c","P.S. 377 Alejandrina B. De Gautier - K377 - K377 - 32K377 - 200 WOODBINE STREET","11e2abc9-30f4-ea11-b882-24ee9a37d45c",-73915159,0,"P.S. 377 - BROOKLYN","200 WOODBINE STREET"
1,0,1,"12c0c20d-ecf6-ea11-b883-24ee9a37d459","P.S. 723 - X723 - X927 - 75X723 - 1455 WEBSTER AVENUE","12497593-33f4-ea11-b882-24ee9a37d45c",-73906419,40837829,"P.S. 927 - BRONX","1455 WEBSTER AVENUE"
1,1,0,"88a9d9c3-32f4-ea11-b882-24ee9a37d45c","I.S. 034 Tottenville - R034 - R034 - 31R034 - 528 ACADEMY AVENUE","87a9d9c3-32f4-ea11-b882-24ee9a37d45c",-74243400,0,"I.S. 34 (OLD TOTTENVILLE) - S.I","528 ACADEMY AVENUE"
13,9,4,"59be7adc-32f4-ea11-b882-24ee9a37d45c","Susan E. Wagner High School - R460 - R460 - 31R460 - 1200 MANOR ROAD","5abe7adc-32f4-ea11-b882-24ee9a37d45c",-74130819,40588985,"SUSAN E. WAGNER HS - S. I.","1200 MANOR ROAD"
1,1,0,"1203cefa-32f4-ea11-b882-24ee9a37d45c","P.S. 041 Gun Hill Road - X041 - X041 - 11X041 - 3352 OLINVILLE AVENUE","1303cefa-32f4-ea11-b882-24ee9a37d45c",-73867834,40874754,"P.S. 41 - BRONX","3352 OLINVILLE AVENUE"
5,4,1,"d6968d36-30f4-ea11-b882-24ee9a37d45c","Brooklyn Arbor Elementary School - K414 - K019 - 14K414 - 325 SOUTH 3 STREET","d7968d36-30f4-ea11-b882-24ee9a37d45c",-73954678,40710107,"P.S. 19 - BROOKLYN","325 SOUTH 3 STREET"
2,0,2,"068b0044-33f4-ea11-b882-24ee9a37d45c","Bronx Delta School - X392 - X192 - 08X392 - 650 HOLLYWOOD AVENUE","078b0044-33f4-ea11-b882-24ee9a37d45c",-73818083,40826794,"I.S. 192 - BRONX","650 HOLLYWOOD AVENUE"
1,1,0,"f98ac007-ebf6-ea11-b883-24ee9a37d459","P.S. 723 - X723 - X701 - 75X723 - 3540 Bivona Street","aaeb0e7b-33f4-ea11-b882-24ee9a37d45c",-73831856,40882980,"P.S. 723 - BRONX","3540 Bivona Street"
1,1,0,"ab32c3fb-eaf6-ea11-b883-24ee9a37d459","P.S. Q224 - Q224 - Q186 - 75Q224 - 252-12 72 AVENUE","67977d2b-32f4-ea11-b882-24ee9a37d45c",-73721594,40749556,"P.S. 186 - QUEENS","252-12 72 AVENUE"
1,1,0,"dab36d80-30f4-ea11-b882-24ee9a37d45c","Legacy School of the Arts - K907 - K190 - 19K907 - 590 SHEFFIELD AVENUE","dbb36d80-30f4-ea11-b882-24ee9a37d45c",-73894877,40662243,"P.S. 190 - BROOKLYN","590 SHEFFIELD AVENUE"
2,0,2,"320b210d-33f4-ea11-b882-24ee9a37d45c","School for Environmental Citizenship - X386 - X079 - 10X386 - 125 EAST 181 STREET","2c0b210d-33f4-ea11-b882-24ee9a37d45c",-73903139,0,"P.S. 79 - BRONX","125 EAST 181 STREET"
1,1,0,"ea77bb9f-33f4-ea11-b882-24ee9a37d45c","Bronx Arena High School - X537 - X972 - 08X537 - 1440 Story Avenue","e877bb9f-33f4-ea11-b882-24ee9a37d45c",-73881187,40820486,"SOUNDVIEW EDUCATIONAL CAMPUS - X","1440 Story Avenue"
2,0,2,"318dbfcf-30f4-ea11-b882-24ee9a37d45c","P.S. 397 Foster-Laurie - K397 - K397 - 17K397 - 490 FENIMORE STREET","328dbfcf-30f4-ea11-b882-24ee9a37d45c",-73946358,40658663,"P.S. 397 - BROOKLYN","490 FENIMORE STREET"
2,2,0,"c82ff20c-32f4-ea11-b882-24ee9a37d45c","P.S./M.S. 114 Belle Harbor - Q114 - Q114 - 27Q114 - 134-01 CRONSTON AVENUE","c12ff20c-32f4-ea11-b882-24ee9a37d45c",-73854364,40577552,"P.S. 114 - QUEENS","134-01 CRONSTON AVENUE"
1,0,1,"09e0ede7-49fb-ea11-b883-24ee9a37d459","Williamsburg Y Head Start - KBWW - KBUN -  - 64 Division Avenue","0ae0ede7-49fb-ea11-b883-24ee9a37d459",0,0,"Williamsburg Y Head Start","64 Division Avenue"
1,1,0,"629d7c62-33f4-ea11-b882-24ee9a37d45c","The Cinema School - X478 - X423 - 12X478 - 1551 EAST 172ND STREET","639d7c62-33f4-ea11-b882-24ee9a37d45c",-73878191,40832508,"JAMES MONROE HS CAMPUS ANNEX - BRONX","1551 EAST 172ND STREET"
1,0,1,"7dc280bd-31f4-ea11-b882-24ee9a37d45c","Manhattan Village Academy - M439 - M873 - 02M439 - 43 WEST 22 STREET","7ec280bd-31f4-ea11-b882-24ee9a37d45c",-73991966,40741963,"MANHATTAN VILLAGE ACADEMY - M","43 WEST 22 STREET"
1,0,1,"409f4974-31f4-ea11-b882-24ee9a37d45c","J.H.S. 143 Eleanor Roosevelt - M143 - M143 - 06M143 - 511 WEST 182ND STREET","3f9f4974-31f4-ea11-b882-24ee9a37d45c",-73930991,40849311,"I.S. 143 - MANHATTAN","511 WEST 182ND STREET"
2,2,0,"8c977d2b-32f4-ea11-b882-24ee9a37d45c","P.S. 195 William Haberle - Q195 - Q195 - 29Q195 - 253-50 149 Avenue","8d977d2b-32f4-ea11-b882-24ee9a37d45c",-73735618,40652641,"P.S. 195 - QUEENS","253-50 149 Avenue"
1,0,1,"b12aa42b-33f4-ea11-b882-24ee9a37d45c","Bronx Charter School for Better Learning II - X484 - X144 - 84X484 - 2545 GUNTHER AVENUE","b22aa42b-33f4-ea11-b882-24ee9a37d45c",-73836525,0,"I.S. 144 - BRONX","2545 GUNTHER AVENUE"
5,3,2,"9f28a20c-31f4-ea11-b882-24ee9a37d45c","P.S. 163 Bath Beach - K163 - K807 - 20K163 - 109 BAY 14TH STREET","9b28a20c-31f4-ea11-b882-24ee9a37d45c",-74007469,40606739,"P.S./ I.S. 163 - BROOKLYN","109 BAY 14TH STREET"
2,2,0,"659d7c62-33f4-ea11-b882-24ee9a37d45c","Mott Hall V - X242 - X423 - 12X242 - 1551 EAST 172ND STREET","639d7c62-33f4-ea11-b882-24ee9a37d45c",-73878191,40832508,"JAMES MONROE HS CAMPUS ANNEX - BRONX","1551 EAST 172ND STREET"
1,0,1,"f89b4c1f-32f4-ea11-b882-24ee9a37d45c","P.S. 160 Walter Francis Bishop - Q160 - Q160 - 28Q160 - 109-59 INWOOD STREET","ee9b4c1f-32f4-ea11-b882-24ee9a37d45c",-73799685,40688373,"P.S. 160 - QUEENS","109-59 INWOOD STREET"
3,1,2,"e4c1392a-30f4-ea11-b882-24ee9a37d45c","Parkside Preparatory Academy - K002 - K002 - 17K002 - 655 Parkside Avenue","dfc1392a-30f4-ea11-b882-24ee9a37d45c",-73951575,40656423,"I.S. 2 - BROOKLYN","655 Parkside Avenue"
2,0,2,"3d767649-31f4-ea11-b882-24ee9a37d45c","P.S. 030 Hernandez/Hughes - M030 - M030 - 05M030 - 144-176 EAST 128 STREET","38767649-31f4-ea11-b882-24ee9a37d45c",-73935461,40805653,"P.S. 30 - MANHATTAN","144-176 EAST 128 STREET"
1,1,0,"a369c231-32f4-ea11-b882-24ee9a37d45c","Energy Tech High School - Q258 - Q204 - 30Q258 - 36-41 28 STREET","9c69c231-32f4-ea11-b882-24ee9a37d45c",-73932628,40756471,"I.S. 204 - QUEENS","36-41 28 STREET"
1,1,0,"86eb6056-32f4-ea11-b882-24ee9a37d45c","The CIVIC School of Bayside Hills - Q390 - Q361 - 26Q390 - 56-10 214 Street","85eb6056-32f4-ea11-b882-24ee9a37d45c",-73764954,0,"P.S. @ 56-10 214 STREET - QUEENS","56-10 214 Street"
1,1,0,"dbd096af-83ef-eb11-b8b1-24ee9a37d45c","P.S. M811 - Mickey Mantle School - M811 - M010 - 75M811 - 2581 7TH AVENUE","9b886843-31f4-ea11-b882-24ee9a37d45c",-73935746,40823988,"I.S. 10 (TANDEM M200) - MANHATTAN","2581 7TH AVENUE"
1,0,1,"58507380-31f4-ea11-b882-24ee9a37d45c","P.S./I.S. 187 Hudson Cliffs - M187 - M187 - 06M187 - 349 CABRINI BOULEVARD","59507380-31f4-ea11-b882-24ee9a37d45c",-73936840,40856239,"P.S./I.S. 187 - MANHATTAN","349 CABRINI BOULEVARD"
1,1,0,"53fdc1bd-32f4-ea11-b882-24ee9a37d45c","P.S. 78 - R078 - R014 - 31R078 - 35 Hill Street","46fdc1bd-32f4-ea11-b882-24ee9a37d45c",-74079228,40622415,"P.S. 14 - STATEN ISLAND","35 Hill Street"
2,0,2,"d3201dab-30f4-ea11-b882-24ee9a37d45c","P.S. 274 Kosciusko - K274 - K274 - 32K274 - 800 BUSHWICK AVENUE","d4201dab-30f4-ea11-b882-24ee9a37d45c",-73928180,40694179,"P.S. 274 - BROOKLYN","800 BUSHWICK AVENUE"
1,0,1,"efc1392a-30f4-ea11-b882-24ee9a37d45c","P.S. 003 The Bedford Village - K003 - K003 - 13K003 - 50 JEFFERSON AVENUE","f0c1392a-30f4-ea11-b882-24ee9a37d45c",-73955219,40682311,"P.S. 3 - BROOKLYN","50 JEFFERSON AVENUE"
3,3,0,"bbba3c50-33f4-ea11-b882-24ee9a37d45c","Comprehensive Model School Project M.S. 327 - X327 - X240 - 09X327 - 1501 JEROME AVENUE","baba3c50-33f4-ea11-b882-24ee9a37d45c",-73916084,40842503,"DOE NEW SETTLEMENT COMMUNITY CAMPUS - X","1501 JEROME AVENUE"
1,1,0,"d3968d36-30f4-ea11-b882-24ee9a37d45c","P.S. 018 Edward Bush - K018 - K018 - 14K018 - 101 MAUJER STREET","d4968d36-30f4-ea11-b882-24ee9a37d45c",-73946695,40710880,"P.S. 18 - BROOKLYN","101 MAUJER STREET"
1,1,0,"02cf496e-31f4-ea11-b882-24ee9a37d45c","Pace High School - M298 - M131 - 02M298 - 100 HESTER STREET","03cf496e-31f4-ea11-b882-24ee9a37d45c",-73993607,0,"I.S. 131 - MANHATTAN","100 HESTER STREET"
5,4,1,"18474313-33f4-ea11-b882-24ee9a37d45c","P.S. 086 Kingsbridge Heights - X086 - X086 - 10X086 - 2756 RESERVOIR AVENUE","19474313-33f4-ea11-b882-24ee9a37d45c",-73897066,40869061,"P.S. 86 - BRONX","2756 RESERVOIR AVENUE"
1,0,1,"9f476368-32f4-ea11-b882-24ee9a37d45c","Flushing High School - Q460 - Q460 - 25Q460 - 35-01 UNION STREET","97476368-32f4-ea11-b882-24ee9a37d45c",-73826811,40764892,"FLUSHING HS - Q","35-01 UNION STREET"
1,1,0,"15ff3d8d-33f4-ea11-b882-24ee9a37d45c","P.S. 086 Kingsbridge Heights - X086 - X868 - 10X086 - 2756 RESERVOIR AVENUE","16ff3d8d-33f4-ea11-b882-24ee9a37d45c",-73897066,40869061,"P.S. 86 MINISCHOOL - BRONX","2756 RESERVOIR AVENUE"
1,0,1,"92886843-31f4-ea11-b882-24ee9a37d45c","P.S. 008 Luis Belliard - M008 - M008 - 06M008 - 465 WEST 167 STREET","93886843-31f4-ea11-b882-24ee9a37d45c",-73936614,40839235,"P.S. 8 - MANHATTAN","465 WEST 167 STREET"
3,1,2,"f717b7f4-32f4-ea11-b882-24ee9a37d45c","M.S. 390 - X390 - X026 - 10X390 - 1930 ANDREWS AVENUE","e917b7f4-32f4-ea11-b882-24ee9a37d45c",-73913016,40854335,"P.S. 396 - BRONX","1930 ANDREWS AVENUE"
1,0,1,"d9883319-32f4-ea11-b882-24ee9a37d45c","P.S. 143 Louis Armstrong - Q143 - Q143 - 24Q143 - 34-74 113 Street","d7883319-32f4-ea11-b882-24ee9a37d45c",-73855715,40755393,"P.S. 143 - QUEENS","34-74 113 Street"
2,1,1,"5ade5eb7-30f4-ea11-b882-24ee9a37d45c","P.S. 306 Ethan Allen - K306 - K306 - 19K306 - 970 VERMONT STREET","59de5eb7-30f4-ea11-b882-24ee9a37d45c",-73886620,40655340,"P.S. 306 - BROOKLYN","970 VERMONT STREET"
1,1,0,"c8edf392-32f4-ea11-b882-24ee9a37d45c","P.S. 007 Louis F. Simeone - Q007 - Q877 - 24Q007 - 76-05 51 AVENUE","c9edf392-32f4-ea11-b882-24ee9a37d45c",-73887011,40737222,"51ST AVENUE ACADEMY - QUEENS","76-05 51 AVENUE"
3,3,0,"60b50aa5-30f4-ea11-b882-24ee9a37d45c","J.H.S. 259 William McKinley - K259 - K259 - 20K259 - 7305 Ft Hamilton Parkway","61b50aa5-30f4-ea11-b882-24ee9a37d45c",-74014633,40626089,"I.S. 259 - BROOKLYN","7305 Ft Hamilton Parkway"
2,1,1,"68977d2b-32f4-ea11-b882-24ee9a37d45c","P.S. 186 Castlewood - Q186 - Q186 - 26Q186 - 252-12 72 AVENUE","67977d2b-32f4-ea11-b882-24ee9a37d45c",-73721594,40749556,"P.S. 186 - QUEENS","252-12 72 AVENUE"
1,0,1,"8f7e21a6-ebf6-ea11-b883-24ee9a37d459","The Riverview School - Q277 - Q311 - 75Q277 - 98-11 44TH AVENUE","36c73b4a-32f4-ea11-b882-24ee9a37d45c",-73865239,0,"P.S./ I.S. 311 - QUEENS","98-11 44TH AVENUE"
1,1,0,"16b7c337-32f4-ea11-b882-24ee9a37d45c","P.S. 223 Lyndon B. Johnson - Q223 - Q223 - 27Q223 - 125-20 Sutphin Boulevard","09b7c337-32f4-ea11-b882-24ee9a37d45c",-73789530,40673898,"P.S. 223 - QUEENS","125-20 Sutphin Boulevard"
1,0,1,"6f41e65b-31f4-ea11-b882-24ee9a37d45c","P.S. 075 Emily Dickinson - M075 - M075 - 03M075 - 735 WEST END AVENUE","6a41e65b-31f4-ea11-b882-24ee9a37d45c",-73973996,40795109,"P.S. 75 - MANHATTAN","735 WEST END AVENUE"
1,1,0,"d192e6d5-30f4-ea11-b882-24ee9a37d45c","The Urban Assembly School for Collaborative Healthcare - K764 - K420 - 19K764 - 999 JAMAICA AVENUE","c692e6d5-30f4-ea11-b882-24ee9a37d45c",-73869305,40693002,"FRANKLIN K. LANE HS - K","999 JAMAICA AVENUE"
3,2,1,"9b476368-32f4-ea11-b882-24ee9a37d45c","Veritas Academy - Q240 - Q460 - 25Q240 - 35-01 UNION STREET","97476368-32f4-ea11-b882-24ee9a37d45c",-73826811,40764892,"FLUSHING HS - Q","35-01 UNION STREET"
1,1,0,"e5ce496e-31f4-ea11-b882-24ee9a37d45c","P.S. 123 Mahalia Jackson - M123 - M123 - 05M123 - 301 WEST 140 STREET","e3ce496e-31f4-ea11-b882-24ee9a37d45c",-73944551,0,"P.S. 123 - MANHATTAN","301 WEST 140 STREET"
1,1,0,"9d69c231-32f4-ea11-b882-24ee9a37d45c","P.S. 203 Oakland Gardens - Q203 - Q203 - 26Q203 - 53-11 SPRINGFIELD BOULEVARD","9e69c231-32f4-ea11-b882-24ee9a37d45c",-73759822,40753606,"P.S. 203 - QUEENS","53-11 SPRINGFIELD BOULEVARD"
1,0,1,"2d767649-31f4-ea11-b882-24ee9a37d45c","P.S. 020 Anna Silver - M020 - M020 - 01M020 - 166 ESSEX STREET","2e767649-31f4-ea11-b882-24ee9a37d45c",-73986312,40721305,"P.S. 20 - MANHATTAN","166 ESSEX STREET"
1,1,0,"dc8442ee-31f4-ea11-b882-24ee9a37d45c","Jamaica Children's School - Q312 - Q040 - 28Q312 - 109-20 Union Hall Street","dd8442ee-31f4-ea11-b882-24ee9a37d45c",-73790975,0,"P.S. 40 (D28) - QUEENS","109-20 Union Hall Street"
1,0,1,"9f53dd74-33f4-ea11-b882-24ee9a37d45c","Marble Hill High School for International Studies - X477 - X475 - 10X477 - 99 TERRACE VIEW AVENUE","9853dd74-33f4-ea11-b882-24ee9a37d45c",-73912686,40877379,"JOHN F. KENNEDY HS - X","99 TERRACE VIEW AVENUE"
1,0,1,"bde0838c-31f4-ea11-b882-24ee9a37d45c","Washington Heights Academy - M366 - M263 - 06M366 - 202 SHERMAN AVE","bee0838c-31f4-ea11-b882-24ee9a37d45c",-73921631,40865575,"PS/IS 263 - Manhattan","202 SHERMAN AVE"
2,2,0,"afeb6056-32f4-ea11-b882-24ee9a37d45c","New Visions Charter High School for Advanced Math and Science IV - Q320 - Q400 - 84Q320 - 156-10 BAISLEY BOULEVARD","a9eb6056-32f4-ea11-b882-24ee9a37d45c",-73782684,40673949,"AUGUST MARTIN HS - QUEENS","156-10 BAISLEY BOULEVARD"
9,8,1,"a40e6e25-32f4-ea11-b882-24ee9a37d45c","Scholars' Academy - Q323 - Q180 - 27Q323 - 320 BEACH 104TH STREET","a50e6e25-32f4-ea11-b882-24ee9a37d45c",-73825162,0,"I.S. 323 (OLD IS 180) - QUEENS","320 BEACH 104TH STREET"
1,0,1,"469587f5-ebf6-ea11-b883-24ee9a37d459","P.S. X017 - X017 - X156 - 75X017 - 750 CONCOURSE VILLAGE WEST","8001ce37-33f4-ea11-b882-24ee9a37d45c",-73922527,40823014,"P.S. 156 - BRONX","750 CONCOURSE VILLAGE WEST"
2,0,2,"76b50aa5-30f4-ea11-b882-24ee9a37d45c","P.S. 264 Bay Ridge Elementary School For The Arts - K264 - K264 - 20K264 - 371 89th Street","74b50aa5-30f4-ea11-b882-24ee9a37d45c",-74029444,40621025,"PS 264 BAY RIDGE ELEM SCL FOR THE ARTS - BROOKLYN","371 89th Street"
2,2,0,"72977d2b-32f4-ea11-b882-24ee9a37d45c","Flushing International High School - Q263 - Q189 - 25Q263 - 144-80 BARCLAY AVENUE","6b977d2b-32f4-ea11-b882-24ee9a37d45c",-73818399,40759963,"J.H.S. 189 - QUEENS","144-80 BARCLAY AVENUE"
2,2,0,"e217b7f4-32f4-ea11-b882-24ee9a37d45c","J.H.S. 022 Jordan L. Mott - X022 - X022 - 09X022 - 270 EAST 167 STREET","de17b7f4-32f4-ea11-b882-24ee9a37d45c",-73914350,40832022,"I.S. 22 - BRONX","270 EAST 167 STREET"
1,1,0,"8b01ce37-33f4-ea11-b882-24ee9a37d45c","Bronx Latin - X267 - X158 - 12X267 - 800 HOME STREET","8601ce37-33f4-ea11-b882-24ee9a37d45c",-73900593,40826933,"I.S. 158 - BRONX","800 HOME STREET"
1,1,0,"6f2f77fa-31f4-ea11-b882-24ee9a37d45c","P.S. 066 Jacqueline Kennedy Onassis - Q066 - Q066 - 27Q066 - 85-11 102 Street","702f77fa-31f4-ea11-b882-24ee9a37d45c",-73846135,40697941,"P.S. 66 - QUEENS","85-11 102 Street"
6,6,0,"435b4cd6-32f4-ea11-b882-24ee9a37d45c","New Dorp High School - R440 - R435 - 31R440 - 465 NEW DORP LANE","fb8521d0-32f4-ea11-b882-24ee9a37d45c",-74105878,40570909,"NEW DORP HS (NEW) - S. I.","465 NEW DORP LANE"
1,0,1,"eb2ece86-32f4-ea11-b882-24ee9a37d45c","Queens Transition Center - Q752 - Q744 - 75Q752 - 45-10 94th Street","e22ece86-32f4-ea11-b882-24ee9a37d45c",-73871505,40743228,"ELMHURST EDUCATIONAL CAMPUS - Q","45-10 94th Street"
1,1,0,"ca92e6d5-30f4-ea11-b882-24ee9a37d45c","Academy of Innovative Technology - K618 - K420 - 19K618 - 999 JAMAICA AVENUE","c692e6d5-30f4-ea11-b882-24ee9a37d45c",-73869305,40693002,"FRANKLIN K. LANE HS - K","999 JAMAICA AVENUE"
1,1,0,"bb3aa668-33f4-ea11-b882-24ee9a37d45c","Bronx High School for Law and Community Service - X439 - X435 - 10X439 - 500 EAST FORDHAM ROAD","b03aa668-33f4-ea11-b882-24ee9a37d45c",-73888625,40859466,"THEODORE ROOSEVELT EDUCATIONAL CAMPUS - X","500 EAST FORDHAM ROAD"
5,5,0,"8c72c880-32f4-ea11-b882-24ee9a37d45c","Thomas A. Edison Career and Technical Education High School - Q620 - Q620 - 28Q620 - 165-65 84 AVENUE","49b4977a-32f4-ea11-b882-24ee9a37d45c",-73799692,40716071,"THOMAS A. EDISON VOC HS - Q","165-65 84 AVENUE"
1,1,0,"950e6e25-32f4-ea11-b882-24ee9a37d45c","P.S. 175 The Lynn Gross Discovery School - Q175 - Q175 - 28Q175 - 64-35 102 STREET","960e6e25-32f4-ea11-b882-24ee9a37d45c",-73852210,40731016,"P.S. 175 - QUEENS","64-35 102 STREET"
1,1,0,"8b32c3fb-eaf6-ea11-b883-24ee9a37d459","Teachers College Community School - M517 - M916 - 05M517 - 168 MORNINGSIDE AVENUE","f0ed94c3-31f4-ea11-b882-24ee9a37d45c",-73953317,0,"TEACHERS COLLEGE COMMUNITY SCHOOL - MANHATTAN","168 MORNINGSIDE AVENUE"
1,0,1,"5b323483-e21e-eb11-b885-24ee9a37d45c","The Richmond Pre-K Center - R066 - R100 - 31R066 - 2389 Richmond Avenue","5c323483-e21e-eb11-b885-24ee9a37d45c",-74165311,0,"3K CENTER @ 2389 RICHMOND AVENUE - STATEN ISLAND","2389 Richmond Avenue"
2,2,0,"546e70b7-31f4-ea11-b882-24ee9a37d45c","Millennium High School - M418 - M824 - 02M418 - 75 BROAD STREET","760c1bb1-31f4-ea11-b882-24ee9a37d45c",-74011202,0,"MILLENNIUM HS - MANHATTAN","75 BROAD STREET"
1,1,0,"4e767649-31f4-ea11-b882-24ee9a37d45c","P.S. 040 Augustus Saint-Gaudens - M040 - M040 - 02M040 - 320 EAST 20TH STREET","46767649-31f4-ea11-b882-24ee9a37d45c",-73981536,40735328,"P.S. 40 - MANHATTAN","320 EAST 20TH STREET"
3,1,2,"f3968d36-30f4-ea11-b882-24ee9a37d45c","P.S. 026 Jesse Owens - K026 - K026 - 16K026 - 1014 LAFAYETTE AVENUE","f2968d36-30f4-ea11-b882-24ee9a37d45c",-73931700,40692100,"P.S. 26 - BROOKLYN","1014 LAFAYETTE AVENUE"
1,0,1,"ba69c231-32f4-ea11-b882-24ee9a37d45c","J.H.S. 210 Elizabeth Blackwell - Q210 - Q210 - 27Q210 - 93-11 101 AVENUE","bb69c231-32f4-ea11-b882-24ee9a37d45c",-73847633,40684760,"I.S. 210 - QUEENS","93-11 101 AVENUE"
1,1,0,"6936d900-33f4-ea11-b882-24ee9a37d45c","P.S. 055 Benjamin Franklin - X055 - X055 - 09X055 - 450 SAINT PAUL'S PLACE","6236d900-33f4-ea11-b882-24ee9a37d45c",-73904970,40835934,"P.S. 55 - BRONX","450 SAINT PAUL'S PLACE"
1,1,0,"9c51be13-ecf6-ea11-b883-24ee9a37d459","P.S. 723 - X723 - XAHW - 75X723 - 595 GERARD AVENUE","3bb205ac-33f4-ea11-b882-24ee9a37d45c",-73929008,40820861,"BRONX CHILDRENS PSYC CENTER","595 GERARD AVENUE"
3,0,3,"77a5db98-30f4-ea11-b882-24ee9a37d45c","Olympus Academy - K635 - K242 - 18K635 - 755 EAST 100 STREET","71a5db98-30f4-ea11-b882-24ee9a37d45c",-73898607,40645965,"P.S. 235 ANNEX - BROOKLYN","755 EAST 100 STREET"
1,0,1,"fabdf08c-32f4-ea11-b882-24ee9a37d45c","North Queens Community High School - Q792 - Q792 - 25Q792 - 141-25 77th Road","fbbdf08c-32f4-ea11-b882-24ee9a37d45c",-73819664,40720586,"NORTH QUEENS COMMUNITY HS - Q","141-25 77th Road"
6,5,1,"686e70b7-31f4-ea11-b882-24ee9a37d45c","West End Secondary School - M291 - M837 - 03M291 - 227-243 West 61st Street","696e70b7-31f4-ea11-b882-24ee9a37d45c",-73988338,40772608,"BEACON HS - MANHATTAN","227-243 West 61st Street"
1,1,0,"8c886843-31f4-ea11-b882-24ee9a37d45c","P.S. 006 Lillie D. Blake - M006 - M006 - 02M006 - 45 EAST 81 STREET","8d886843-31f4-ea11-b882-24ee9a37d45c",-73960427,40777737,"P.S. 6 - MANHATTAN","45 EAST 81 STREET"
1,1,0,"fe77931f-33f4-ea11-b882-24ee9a37d45c","School of Performing Arts - X217 - X116 - 12X217 - 977 FOX STREET","fd77931f-33f4-ea11-b882-24ee9a37d45c",-73894368,40822056,"I.S. 216 - BRONX","977 FOX STREET"
1,1,0,"69e9a5af-4afb-ea11-b883-24ee9a37d459","YMCA OF GREATER NEW YORK - FLUSHING - QAJR - QAJR -  - 138-46 Northern Boulevard","6ae9a5af-4afb-ea11-b883-24ee9a37d459",-73827142,40764119,"Flushing YMCA UPK","138-46 Northern Boulevard"
1,0,1,"b028a20c-31f4-ea11-b882-24ee9a37d45c","Aspirations Diploma Plus High School - K646 - K824 - 17K646 - 402 EASTERN PARKWAY","ae28a20c-31f4-ea11-b882-24ee9a37d45c",-73955188,40669561,"W.E.B. DUBOIS HS - BROOKLYN","402 EASTERN PARKWAY"
2,0,2,"f1d10307-33f4-ea11-b882-24ee9a37d45c","P.S. 071 Rose E. Scala - X071 - X071 - 08X071 - 3040 ROBERTS AVENUE","e3d10307-33f4-ea11-b882-24ee9a37d45c",-73829562,40845379,"P.S. 71 - BRONX","3040 ROBERTS AVENUE"
2,2,0,"2f06003e-32f4-ea11-b882-24ee9a37d45c","The Active Learning Elementary School - Q244 - Q244 - 25Q244 - 137-20 FRANKLIN AVENUE","2b06003e-32f4-ea11-b882-24ee9a37d45c",-73826192,40754483,"P.S. 244 ECC (@ FRANKLIN AVE) - Q","137-20 FRANKLIN AVENUE"
1,1,0,"782f77fa-31f4-ea11-b882-24ee9a37d45c","P.S. 069 Jackson Heights - Q069 - Q069 - 30Q069 - 77-02 37 AVENUE","682f77fa-31f4-ea11-b882-24ee9a37d45c",-73888457,40748804,"P.S. 69 - QUEENS","77-02 37 AVENUE"
1,0,1,"d7b66262-32f4-ea11-b882-24ee9a37d45c","William Cullen Bryant High School - Q445 - Q445 - 30Q445 - 48-10 31 AVENUE","d8b66262-32f4-ea11-b882-24ee9a37d45c",-73911165,40757072,"WILLIAM C. BRYANT HS - Q","48-10 31 AVENUE"
2,2,0,"568946f4-31f4-ea11-b882-24ee9a37d45c","P.S. 043 - Q043 - Q043 - 27Q043 - 160 BEACH 29 STREET","ee8442ee-31f4-ea11-b882-24ee9a37d45c",-73761086,40593480,"P.S. 43 - QUEENS","160 BEACH 29 STREET"
2,0,2,"269ebaee-32f4-ea11-b882-24ee9a37d45c","P.S. X012 Lewis and Clark School - X012 - X012 - 75X012 - 2555 TRATMAN AVENUE","279ebaee-32f4-ea11-b882-24ee9a37d45c",-73844685,40840625,"P.S. 12 - BRONX","2555 TRATMAN AVENUE"
2,2,0,"2aa6ba98-31f4-ea11-b882-24ee9a37d45c","High School for Media and Communications - M463 - M465 - 06M463 - 549 AUDUBON AVENUE","25a6ba98-31f4-ea11-b882-24ee9a37d45c",-73926060,40856532,"G. WASHINGTON HS EDUC. CAMPUS - M","549 AUDUBON AVENUE"
1,1,0,"da2ece86-32f4-ea11-b882-24ee9a37d45c","High School of Applied Communication - Q267 - Q735 - 24Q267 - 30-20 THOMSON AVENUE","db2ece86-32f4-ea11-b882-24ee9a37d45c",-73937004,0,"QUEENS HIGH SCHOOL COMPLEX - Q","30-20 THOMSON AVENUE"
3,0,3,"74f4a0ef-eaf6-ea11-b883-24ee9a37d459","P.S. 370 - K370 - K370 - 75K370 - 3000 WEST 1 STREET","0be2abc9-30f4-ea11-b882-24ee9a37d45c",-73969872,40577709,"P.S. 370 - BROOKLYN","3000 WEST 1 STREET"
1,0,1,"31a10a44-32f4-ea11-b882-24ee9a37d45c","P.S. 251 Queens - Q251 - Q251 - 29Q251 - 144-51 Arthur Street","32a10a44-32f4-ea11-b882-24ee9a37d45c",-73759396,0,"P.S. 251 (TANDEM Q231) - QUEENS","144-51 Arthur Street"
2,1,1,"c98442ee-31f4-ea11-b882-24ee9a37d45c","P.S. 032 State Street - Q032 - Q032 - 25Q032 - 171-11 35 AVENUE","ca8442ee-31f4-ea11-b882-24ee9a37d45c",-73794323,40765459,"P.S. 32 - QUEENS","171-11 35 AVENUE"
1,0,1,"f3a2f813-ebf6-ea11-b883-24ee9a37d459","P.S. 370 - K370 - K100 - 75K370 - 2951 WEST 3 STREET","ca0d3c5b-30f4-ea11-b882-24ee9a37d45c",-73970830,40577591,"P.S. 100 - BROOKLYN","2951 WEST 3 STREET"
1,0,1,"34c15a75-ebf6-ea11-b883-24ee9a37d459","P.S. M721 - Manhattan Occupational Training Center - M721 - M844 - 75M721 - 400 First Avenue","746e70b7-31f4-ea11-b882-24ee9a37d45c",-73978085,40736999,"P.S. 138 ANNEX (OLD M047 AX) - M","400 First Avenue"
1,0,1,"ae56635c-33f4-ea11-b882-24ee9a37d45c","New Visions AIM Charter High School II - X200 - X401 - 84X200 - 1010 REV. J. A. POLITE AVENUE","8ce03d56-33f4-ea11-b882-24ee9a37d45c",-73898265,40823124,"BRONX REGIONAL HS (OLD 133) - X","1010 REV. J. A. POLITE AVENUE"
3,0,3,"d1b36d80-30f4-ea11-b882-24ee9a37d45c","P.S. 186 Dr. Irving A Gladstone - K186 - K186 - 20K186 - 7601 19 AVENUE","d2b36d80-30f4-ea11-b882-24ee9a37d45c",-73994258,40610917,"P.S. 186 - BROOKLYN","7601 19 AVENUE"
1,1,0,"430410ca-32f4-ea11-b882-24ee9a37d45c","Space Shuttle Columbia School - R058 - R058 - 31R058 - 77 MARSH AVENUE","2a0410ca-32f4-ea11-b882-24ee9a37d45c",-74160867,0,"P.S. 58 - STATEN ISLAND","77 MARSH AVENUE"
5,4,1,"8fa9d9c3-32f4-ea11-b882-24ee9a37d45c","P.S. 036 J. C. Drumgoole - R036 - R036 - 31R036 - 255 IONIA AVENUE","8ba9d9c3-32f4-ea11-b882-24ee9a37d45c",-74182548,0,"P.S. 36 - STATEN ISLAND","255 IONIA AVENUE"
1,0,1,"0d822706-f07b-ed11-b0c6-088e901ef405","New Visions Charter High School for Advanced Math and Science III - K738 - K496 - 84K738 - 3000 Avenue X","7277bcf4-7bb4-ec11-b8d4-24ee9a37d45c",-73936635,40593157,"SHEEPSHEAD BAY AF - BROOKLYN","3000 Avenue X"
1,0,1,"29b7c337-32f4-ea11-b882-24ee9a37d45c","I.S. 227 Louis Armstrong - Q227 - Q227 - 30Q227 - 32-02 JUNCTION BOULEVARD","27b7c337-32f4-ea11-b882-24ee9a37d45c",-73874614,40757567,"I.S. 227 - QUEENS","32-02 JUNCTION BOULEVARD"
2,2,0,"a153dd74-33f4-ea11-b882-24ee9a37d45c","New Visions Charter High School for Advanced Math and Science - X539 - X475 - 84X539 - 99 TERRACE VIEW AVENUE","9853dd74-33f4-ea11-b882-24ee9a37d45c",-73912686,40877379,"JOHN F. KENNEDY HS - X","99 TERRACE VIEW AVENUE"
